"hash","ver","vin_sz","vout_sz","size","weight","fee","relayed_by","lock_time","tx_index","double_spend","time","block_index","block_height","inputs","out","result","balance"
"283807742bc7ba3a01470b821ef986fa1a3b37ebba0616387e8dda8c21cf16f4",1,1,1,194,449,339,"0.0.0.0",0,8588121649290065,false,1690081566,810118,810118,"[{""sequence"":4294967293,""witness"":""024730440220443f0bdbb8e2389276291f5ff4f761d4f68d3937d95386eb7f6e5b948c28dbec0220603b2bb8209f54cda8660aaba3f12df667278b63a7fbe0ef07b52a1eeb2f9c13012102282d7cb7b74bb7fdd3042e77e138f3158c218bc193b4d3ac173db970e81c70fd"",""script"":"""",""index"":0,""prev_out"":{""addr"":""bc1qf4rutpxturce9ddum9fwlnpg3446enux69mxjv"",""n"":0,""script"":""00144d47c584cbe0f192b5bcd952efcc288d6baccf86"",""spending_outpoints"":[{""n"":0,""tx_index"":8588121649290065}],""spent"":true,""tx_index"":7745574288042780,""type"":0,""value"":986}}]","[{""type"":0,""spent"":false,""value"":647,""spending_outpoints"":[],""n"":0,""tx_index"":8588121649290065,""script"":""76a914a0b0d60e5991578ed37cbda2b17d8b2ce23ab29588ac"",""addr"":""1FeexV6bAHb8ybZjqQMjJrcCrHGW9sb6uF""}]",647,7995726462896
"8669cfa4ffa85759cf387d578fd46c356c6b011b726e24edd9a30ec43050411e",1,1,1,192,768,2304,"0.0.0.0",0,1064507746582996,false,1695623725,809250,809250,"[{""sequence"":4294967295,""witness"":"""",""script"":""483045022100fa68d701471841b105b8c60e0cbb7df9bf87f2889cb2297890c33c058e1a8afe02207c6ab2ab2aa033e47f2c5c6907e9573a5ae14cd07c84a353d2189c39a835a4430121036011efea758ab47d35120e01f88dd715a4f1e4da08a8c03a71400bf6026789d7"",""index"":0,""prev_out"":{""addr"":""14cvro5hazSS3NuAvzhX1DKZnC6Cm5AHj8"",""n"":3,""script"":""76a91427b3e514b57dc3ccb2147b299f80d058efda4db188ac"",""spending_outpoints"":[{""n"":0,""tx_index"":1064507746582996}],""spent"":true,""tx_index"":6869387355508812,""type"":0,""value"":23851}}]","[{""type"":0,""spent"":false,""value"":21547,""spending_outpoints"":[],""n"":0,""tx_index"":1064507746582996,""script"":""76a914a0b0d60e5991578ed37cbda2b17d8b2ce23ab29588ac"",""addr"":""1FeexV6bAHb8ybZjqQMjJrcCrHGW9sb6uF""}]",21547,7995726462249
"114e7ef878cc06d5832455a03332ee6075903b7356ea30acc97787c16030a1dc",1,3,1,486,1944,5856,"0.0.0.0",0,7762715503767790,false,1695620420,809244,809244,"[{""sequence"":4294967295,""witness"":"""",""script"":""473044022039c03f9b5893c3221d5c75d892e5e9570ee82aa00f3fcb7377be386f2fd033a602200ad07fc8fe97a46bc7f3f1fdea17f44e237fbb3b3eeb5db29b4bc0b260d0348b0121034dea75deea6f737e8363240a1c79303076f663b980729acdfb4e791bf285916c"",""index"":0,""prev_out"":{""addr"":""19nXfk4hCarJNzpaMdHCXsg4jY7dWsEfzo"",""n"":1,""script"":""76a914605d532bba85cde2889c7331a7001e3957beb88988ac"",""spending_outpoints"":[{""n"":0,""tx_index"":7762715503767790}],""spent"":true,""tx_index"":4667072184970614,""type"":0,""value"":1829}},{""sequence"":4294967295,""witness"":"""",""script"":""47304402201eb41b2c1202ba22edc2cca39ac1c53386c309e389f4d66eaadf5ace72943cac022071bcd927f177419f7e89c3a78cb9e7707a7494cdde12a05cc1c3a5b4b3aba9fc01210348d4ade459c7037a313140cd5e1bd38c88356000efa6118b02ad78bbc9684d7c"",""index"":1,""prev_out"":{""addr"":""1DPKjQMWoLuM2j71c9sXJiSqVhDprWBfqd"",""n"":1,""script"":""76a91487da4be64f56b1945ff509051f088ceb9bfc8a0a88ac"",""spending_outpoints"":[{""n"":1,""tx_index"":7762715503767790}],""spent"":true,""tx_index"":6548453682887936,""type"":0,""value"":2022}},{""sequence"":4294967295,""witness"":"""",""script"":""4830450221009670eac670f1d5a22f72f02d5bc0328e6a5954b16b8978e436de04f5534961660220219d0f8b39a1fceecb517725fa5fa9664ac89a1a6982dd1499608ceeb63215480121023f2cf9b2b768ecc2b9ec677f68f208bfbbbe4f940b0d63bf0bf80fc69dc2c55b"",""index"":2,""prev_out"":{""addr"":""16kfqVA3YZPNsCB7kntF8whjvUD5Eh43eu"",""n"":1,""script"":""76a9143f1aef140621fe88fe59967f9ad98c6c36408f3a88ac"",""spending_outpoints"":[{""n"":2,""tx_index"":7762715503767790}],""spent"":true,""tx_index"":8941576148061130,""type"":0,""value"":3394}}]","[{""type"":0,""spent"":false,""value"":1389,""spending_outpoints"":[],""n"":0,""tx_index"":7762715503767790,""script"":""76a914a0b0d60e5991578ed37cbda2b17d8b2ce23ab29588ac"",""addr"":""1FeexV6bAHb8ybZjqQMjJrcCrHGW9sb6uF""}]",1389,7995726440702
"20a14a56f55b0a171e12edc3ababcc67dab3615e0c8240e489783c993e3f64c9",1,1,2,225,900,5876,"0.0.0.0",0,7085836639348623,false,1695504150,809044,809044,"[{""sequence"":4294967295,""witness"":"""",""script"":""473044022075c077486afc775e84530ac6322b704b035f910b49f559197ba64801ab3b767702201dfc4f1bdeb025ba2521f851aca299936896d5e762964634f7791c9e9278a4c3812102a4fd603592a65817c1f2a862e7ad5254251055e65f324c3a46c172b99a715195"",""index"":0,""prev_out"":{""addr"":""1MGCuCQNspfEaqCXb2NiGMSyPa4cHibkh7"",""n"":0,""script"":""76a914de42b04ce42742aefa7360c2ce4aa872b26af89488ac"",""spending_outpoints"":[{""n"":0,""tx_index"":7085836639348623}],""spent"":true,""tx_index"":3663089400529886,""type"":0,""value"":319587}}]","[{""type"":0,""spent"":false,""value"":225629,""spending_outpoints"":[],""n"":0,""tx_index"":7085836639348623,""script"":""76a914a0b0d60e5991578ed37cbda2b17d8b2ce23ab29588ac"",""addr"":""1FeexV6bAHb8ybZjqQMjJrcCrHGW9sb6uF""},{""type"":0,""spent"":false,""value"":88082,""spending_outpoints"":[],""n"":1,""tx_index"":7085836639348623,""script"":""76a914de42b04ce42742aefa7360c2ce4aa872b26af89488ac"",""addr"":""1MGCuCQNspfEaqCXb2NiGMSyPa4cHibkh7""}]",225629,7995726439313
"79e676bd52bbc35dd5d35d991225529baf93c636a9305fb5be9ca0971674d79a",1,2,2,372,1488,13661,"0.0.0.0",0,5448005001081875,false,1694035614,806512,806512,"[{""sequence"":4294967295,""witness"":"""",""script"":""47304402206e2fa2a050644b69831200ebb6efa81f731bccc7e2060a155cd939e0b8c1f5aa022023217b3a4f83d25bd8b82fcb8de71c782f8fb972e3113dba6d7024dffb32276e0121020f5db72fed92dd3e756352b546539a222ad556642a5203f49b2352013c9f7fd1"",""index"":0,""prev_out"":{""addr"":""16mtepxN1k1TCUsVR6rthvBTZqxEcxNU5Q"",""n"":0,""script"":""76a9143f560c5e21a380ff3d0cdfbd39d87b12bb1e581888ac"",""spending_outpoints"":[{""n"":0,""tx_index"":5448005001081875}],""spent"":true,""tx_index"":4471338970639165,""type"":0,""value"":2742}},{""sequence"":4294967295,""witness"":"""",""script"":""473044022020d8f0ab94fbb04f20eb6221b293373b9d2c5b4201580f12f5b02c6590079b6202202cf01bfe3b968438812499c1010a283781d7f0eaee2441c9a38c5856ba5190e60121020f5db72fed92dd3e756352b546539a222ad556642a5203f49b2352013c9f7fd1"",""index"":1,""prev_out"":{""addr"":""16mtepxN1k1TCUsVR6rthvBTZqxEcxNU5Q"",""n"":35,""script"":""76a9143f560c5e21a380ff3d0cdfbd39d87b12bb1e581888ac"",""spending_outpoints"":[{""n"":1,""tx_index"":5448005001081875}],""spent"":true,""tx_index"":8848479221922195,""type"":0,""value"":70000}}]","[{""type"":0,""spent"":false,""value"":15828,""spending_outpoints"":[],""n"":0,""tx_index"":5448005001081875,""script"":""76a914a0b0d60e5991578ed37cbda2b17d8b2ce23ab29588ac"",""addr"":""1FeexV6bAHb8ybZjqQMjJrcCrHGW9sb6uF""},{""type"":0,""spent"":false,""value"":43253,""spending_outpoints"":[],""n"":1,""tx_index"":5448005001081875,""script"":""76a9140cb1f7310724c2381338aafb2f28e801007b490488ac"",""addr"":""12A8JZwyH9tnpg1gg7puZdntjajbzPDALs""}]",15828,7995726213684
"795f1726ecd3a52a687eca5f69ed5a5f8e10a8baf93a4f730716174300d6082e",1,1,21,832,3001,37550,"0.0.0.0",0,1619695518638818,false,1693432138,805499,805499,"[{""sequence"":4294967295,""witness"":""0247304402204e8d2afbcf57b8653811a15c9e519fc1f43db6d9a2c6940a51e705c996f617c2022043b234f1c051eedbe1ab5a1b03d9497f1ca565fd1c9814890ca04d7d759f800e012102174ee672429ff94304321cdae1fc1e487edf658b34bd1d36da03761658a2bb09"",""script"":"""",""index"":0,""prev_out"":{""addr"":""bc1qm34lsc65zpw79lxes69zkqmk6ee3ewf0j77s3h"",""n"":1,""script"":""0014dc6bf86354105de2fcd9868a2b0376d6731cb92f"",""spending_outpoints"":[{""n"":0,""tx_index"":1619695518638818}],""spent"":true,""tx_index"":7910662189325047,""type"":0,""value"":935835274}}]","[{""type"":0,""spent"":true,""value"":894149,""spending_outpoints"":[{""tx_index"":4870376691540595,""n"":2}],""n"":0,""tx_index"":1619695518638818,""script"":""0014d3f7d40b8afbd670556fb95901af78e312870ad3"",""addr"":""bc1q60magzu2l0t8q4t0h9vsrtmcuvfgwzknq2uawr""},{""type"":0,""spent"":true,""value"":617083998,""spending_outpoints"":[{""tx_index"":1353046864645629,""n"":0}],""n"":1,""tx_index"":1619695518638818,""script"":""0014dc6bf86354105de2fcd9868a2b0376d6731cb92f"",""addr"":""bc1qm34lsc65zpw79lxes69zkqmk6ee3ewf0j77s3h""},{""type"":0,""spent"":true,""value"":58223,""spending_outpoints"":[{""tx_index"":4489763320949252,""n"":0}],""n"":2,""tx_index"":1619695518638818,""script"":""0014899170f005c8e60e50439b38049449ba04772183"",""addr"":""bc1q3xghpuq9ernqu5zrnvuqf9zfhgz8wgvrm4sdwp""},{""type"":0,""spent"":true,""value"":229267,""spending_outpoints"":[{""tx_index"":1791731493800622,""n"":368}],""n"":3,""tx_index"":1619695518638818,""script"":""a914a77295cbc477ad77a90951dacc3e406b2df2536887"",""addr"":""3GxQ36SPSEF8jqXuua69khG5swPFHze68X""},{""type"":0,""spent"":true,""value"":2297977,""spending_outpoints"":[{""tx_index"":164790116788168,""n"":26}],""n"":4,""tx_index"":1619695518638818,""script"":""76a9144e75e71e3e685ac46b4c11d3b54322e14160725488ac"",""addr"":""189rwzcT2YWYeyU4Tevb2XeezcarHAHrVs""},{""type"":0,""spent"":true,""value"":123479,""spending_outpoints"":[{""tx_index"":5001028388885844,""n"":368}],""n"":5,""tx_index"":1619695518638818,""script"":""00145d0b05e81a5069a34d47065beaa0732c8545c7d2"",""addr"":""bc1qt59st6q62p56xn28qed74grn9jz5t37jslg0ta""},{""type"":0,""spent"":true,""value"":106200,""spending_outpoints"":[{""tx_index"":6487604986447509,""n"":1}],""n"":6,""tx_index"":1619695518638818,""script"":""0014ff55543e259050d9f4612580c21b066383abf4e9"",""addr"":""bc1qla24g039jpgdnarpykqvyxcxvwp6ha8f9fs3q9""},{""type"":0,""spent"":true,""value"":5323959,""spending_outpoints"":[{""tx_index"":5623169978745436,""n"":2}],""n"":7,""tx_index"":1619695518638818,""script"":""a914a5f53bd4df4a7d7496af26be72386b7e1ad1fc1b87"",""addr"":""3GpXCLGwTW1depwsi4z1FshvHmNueB9nba""},{""type"":0,""spent"":false,""value"":39458,""spending_outpoints"":[],""n"":8,""tx_index"":1619695518638818,""script"":""76a914a0b0d60e5991578ed37cbda2b17d8b2ce23ab29588ac"",""addr"":""1FeexV6bAHb8ybZjqQMjJrcCrHGW9sb6uF""},{""type"":0,""spent"":false,""value"":69484,""spending_outpoints"":[],""n"":9,""tx_index"":1619695518638818,""script"":""a914c477a35d6eebc793784b1d917e79d01fa58dcfbc87"",""addr"":""3KbqgkFYohQJGiP4YSGYTsX2k1ustVqzuq""},{""type"":0,""spent"":true,""value"":249995000,""spending_outpoints"":[{""tx_index"":6250781701622648,""n"":35}],""n"":10,""tx_index"":1619695518638818,""script"":""76a914b12b29dfa9bad1548cd60536e51724fc924cdd1388ac"",""addr"":""1H9nK1f9iJXUxF1Rn8PsvBTPi3fBVWgZsP""},{""type"":0,""spent"":true,""value"":35394,""spending_outpoints"":[{""tx_index"":8766772831356520,""n"":247}],""n"":11,""tx_index"":1619695518638818,""script"":""0014010bfa49d25df83e2a9718e4c5ae12198c19b71b"",""addr"":""bc1qqy9l5jwjthuru25hrrjvttsjrxxpndcmvkx37u""},{""type"":0,""spent"":true,""value"":114521,""spending_outpoints"":[{""tx_index"":6450078139031293,""n"":187}],""n"":12,""tx_index"":1619695518638818,""script"":""a914785d2512f47bf4071a10abbf51c58448cf6f94e487"",""addr"":""3CfSbNwB6b4G7E5eoaD1HA7NZGFzhCh9NB""},{""type"":0,""spent"":true,""value"":47943182,""spending_outpoints"":[{""tx_index"":4149936037388354,""n"":168}],""n"":13,""tx_index"":1619695518638818,""script"":""a914d4c6154cbbc8e1ec8aed7c40112b34c56c72c59987"",""addr"":""3M64UGqt8DPyqurF8An15KXKdB61vuoEtu""},{""type"":0,""spent"":true,""value"":981518,""spending_outpoints"":[{""tx_index"":7700635489651869,""n"":0}],""n"":14,""tx_index"":1619695518638818,""script"":""76a914751650dc4698c531ad44b42f0812fa9327b1008788ac"",""addr"":""1Bg6nygtNcogAQtCTCSHRQHdzA6W1fBETu""},{""type"":0,""spent"":false,""value"":9223595,""spending_outpoints"":[],""n"":15,""tx_index"":1619695518638818,""script"":""00140aa3c615011234282e77dd7b4cc890d6bf12b11b"",""addr"":""bc1qp23uv9gpzg6zstnhm4a5ejys66l39vgmyphyzx""},{""type"":0,""spent"":true,""value"":38000,""spending_outpoints"":[{""tx_index"":2451471269510451,""n"":10}],""n"":16,""tx_index"":1619695518638818,""script"":""0014f83b4e9b7f41ee7256b24b71d817b9f52593f5a6"",""addr"":""bc1qlqa5axmlg8h8y44jfdcas9ae75je8adx8urz2f""},{""type"":0,""spent"":true,""value"":32700,""spending_outpoints"":[{""tx_index"":7943446343533205,""n"":1}],""n"":17,""tx_index"":1619695518638818,""script"":""0014de1b7e1bcc04afcfaa75834be393e694f80ec1fe"",""addr"":""bc1qmcdhux7vqjhul2n4sd978ylxjnuqas07umwdjq""},{""type"":0,""spent"":true,""value"":966156,""spending_outpoints"":[{""tx_index"":2826212152845980,""n"":303}],""n"":18,""tx_index"":1619695518638818,""script"":""76a91486ac2d5edd0a3ea02a07e67f287e15d16b4a8ca988ac"",""addr"":""1DH5onkiRu6ipbvJubgfoh5L6PksCvmkar""},{""type"":0,""spent"":false,""value"":40000,""spending_outpoints"":[],""n"":19,""tx_index"":1619695518638818,""script"":""a914e1498d4299a05291d2756738dd8dceeb8c6db5c587"",""addr"":""3NEE5B3rnQUkrbmwLeCHZNAjKjPKiaHxnW""},{""type"":0,""spent"":true,""value"":201464,""spending_outpoints"":[{""tx_index"":1390542003860036,""n"":0}],""n"":20,""tx_index"":1619695518638818,""script"":""0014e6effdbe0e61c5299985e1c759dc94ddc4fac762"",""addr"":""bc1qumhlm0swv8zjnxv9u8r4nhy5mhz043mzhq3jgw""}]",39458,7995726197856
"99338662c7eed637f3e592b764d3aaf658752342cd0862fa80e046f7b977ce3b",1,2,1,344,722,1726,"0.0.0.0",0,2104254655293660,false,1692964405,804793,804793,"[{""sequence"":4294967295,""witness"":""02483045022100c85476e41db9f53c280adbd3e5eba931796c8eb54c547b7fd8e72228cdcf577d0220471a0abba9102af0028ad0ad10932200a8c7797da3941f4363d459f7c88ada5c0121027d40bbaacc6688e1c13ee2f4c0edd2d189c7df18d1968d77f6bdca9165883231"",""script"":"""",""index"":0,""prev_out"":{""addr"":""bc1qfzw74yd0agtxjupk4rspe0m5qwpecw505pkrus"",""n"":1,""script"":""0014489dea91afea16697036a8e01cbf7403839c3a8f"",""spending_outpoints"":[{""n"":0,""tx_index"":2104254655293660}],""spent"":true,""tx_index"":1700834789702396,""type"":0,""value"":3887}},{""sequence"":4294967295,""witness"":""024830450221008e59091e59891afc4d8ad07b6d9a3f7b2af2dc033f522078774fac669360692202205935d536445d3736afbb9e618b39f25ecc0fed5622a4205e8cfd698f1e5911a001210345402e0c3f5a82c5f8022bad0b2720c07835b08c2689eb5acbb21ef2b8e27733"",""script"":"""",""index"":1,""prev_out"":{""addr"":""bc1qxt7g94mwjjqqe4clcsvxs48tyaaxerlfayuya6"",""n"":1,""script"":""001432fc82d76e94800cd71fc4186854eb277a6c8fe9"",""spending_outpoints"":[{""n"":1,""tx_index"":2104254655293660}],""spent"":true,""tx_index"":2809548124566408,""type"":0,""value"":9338}}]","[{""type"":0,""spent"":false,""value"":11499,""spending_outpoints"":[],""n"":0,""tx_index"":2104254655293660,""script"":""76a914a0b0d60e5991578ed37cbda2b17d8b2ce23ab29588ac"",""addr"":""1FeexV6bAHb8ybZjqQMjJrcCrHGW9sb6uF""}]",11499,7995726158398
"e7a01bbb7e2a5635bb4c796d48cbb6599d126a0b9911feabf15dc7838c33b831",1,1,2,225,573,1296,"0.0.0.0",0,1749350674888939,false,1692935090,804741,804741,"[{""sequence"":4294967293,""witness"":""024730440220432aa01b9dc3fb084bdae212a0870ddd62d796f0dc14466bad173e3b2120b08102202ec18db2f6dc295bc3ae4cc691b9b7eb13cd9bbc3d3e85a1a4f6dd4142f45d9e012103b9df5595ecd79c3a4c444e28af824e05aa6a11379b6b376a9351678c45d39317"",""script"":"""",""index"":0,""prev_out"":{""addr"":""bc1qa9kn8qkwhe7gpanqvced5kf8zj79wdtmz4stsu"",""n"":10,""script"":""0014e96d3382cebe7c80f6606632da592714bc57357b"",""spending_outpoints"":[{""n"":0,""tx_index"":1749350674888939}],""spent"":true,""tx_index"":7345547913909061,""type"":0,""value"":220009}}]","[{""type"":0,""spent"":false,""value"":76719,""spending_outpoints"":[],""n"":0,""tx_index"":1749350674888939,""script"":""76a914a0b0d60e5991578ed37cbda2b17d8b2ce23ab29588ac"",""addr"":""1FeexV6bAHb8ybZjqQMjJrcCrHGW9sb6uF""},{""type"":0,""spent"":false,""value"":141994,""spending_outpoints"":[],""n"":1,""tx_index"":1749350674888939,""script"":""001494e367af8dac285e5d1b37bd6b1fba3f6da5d9f0"",""addr"":""bc1qjn3k0tud4s59uhgmx77kk8a68ak6tk0snsupzj""}]",76719,7995726146899
"d76534df2ad196242a975207c8baa24fd246e36210513ffe6b620d5068fc2581",2,1,1,223,892,11424,"0.0.0.0",803916,4544004750967212,false,1692463394,803917,803917,"[{""sequence"":4294967293,""witness"":"""",""script"":""47304402206f79504cae9c967ccc2cac21bc1904bcba8fec620bc66efd29d1af3cf6d4a44b022056f44c8489a33ac656655a594838a1f9ebe2053109e0d57f990b9730c784f9780141045745b244148e16644609d008c413a0b01c61c8758f4f10b0af49ddbbd75a1370bae46cca601020603582049816c343dfdd3dea05fe7ac58aa889fc8ba2aa8420"",""index"":0,""prev_out"":{""addr"":""1FeexV6yF2zRuwjF1FNGS7sBbLsKDpyJY3"",""n"":10,""script"":""76a914a0b0d60e74e540ad98cce53e885035ec9735363188ac"",""spending_outpoints"":[{""n"":0,""tx_index"":4544004750967212}],""spent"":true,""tx_index"":2653134176505748,""type"":0,""value"":27166}}]","[{""type"":0,""spent"":false,""value"":15742,""spending_outpoints"":[],""n"":0,""tx_index"":4544004750967212,""script"":""76a914a0b0d60e5991578ed37cbda2b17d8b2ce23ab29588ac"",""addr"":""1FeexV6bAHb8ybZjqQMjJrcCrHGW9sb6uF""}]",15742,7995726070180
"bd790639ab4dcf5faca79540160614ce3af7af955f864e00205decfca49b4191",1,1,2,226,574,1296,"0.0.0.0",0,5110751045852555,false,1691791458,802718,802718,"[{""sequence"":4294967293,""witness"":""02483045022100bbdc655e454b955a74fd6d930b3094055e90f2766d9a78863d90952f04d21fa1022028def3fb698780414e8bae4a933cdd5e477bb3ff458d333fccf178b118b39c05012102ed5eb279f2c4cde3f4e7319d85c6d338074f346c30b5518e2490549e3ec3bf16"",""script"":"""",""index"":0,""prev_out"":{""addr"":""bc1qqyvgwl6y8talnjpwft8ghc6wsuguxj98ejl2rh"",""n"":1,""script"":""00140118877f443afbf9c82e4ace8be34e8711c348a7"",""spending_outpoints"":[{""n"":0,""tx_index"":5110751045852555}],""spent"":true,""tx_index"":4748021854014319,""type"":0,""value"":33227}}]","[{""type"":0,""spent"":false,""value"":1351,""spending_outpoints"":[],""n"":0,""tx_index"":5110751045852555,""script"":""76a914a0b0d60e5991578ed37cbda2b17d8b2ce23ab29588ac"",""addr"":""1FeexV6bAHb8ybZjqQMjJrcCrHGW9sb6uF""},{""type"":0,""spent"":true,""value"":30580,""spending_outpoints"":[{""tx_index"":2036857289471339,""n"":0}],""n"":1,""tx_index"":5110751045852555,""script"":""0014f55d8d083e75ded8f7ab325f7369b7bb54253a8d"",""addr"":""bc1q74wc6zp7wh0d3aatxf0hx6dhhd2z2w5dely7lr""}]",1351,7995726054438
"607f01096e83be6949b0ef30f1069be251edc1b6bf5205eba27b5bf4df67f286",1,1,2,226,574,1296,"0.0.0.0",0,4748021854014319,false,1691791413,802718,802718,"[{""sequence"":4294967293,""witness"":""02483045022100cdb1a0d9d50ddf9365ba0e777253d15a5b2e61a74d76f1ba0e5f9742cd28c52902201923adf1d5aefd5e020b3ed83e40840be7e253c19913d9baafecf9e8a0a2356f012102a416cdc21a4513382a1b64ad0fd4f5656fc008029fd2237e8f9a6d2115e302ad"",""script"":"""",""index"":0,""prev_out"":{""addr"":""bc1q6a3ua2cxnmtwvj4e3l90h93g8fh07ujf3e36uz"",""n"":182,""script"":""0014d763ceab069ed6e64ab98fcafb96283a6eff7249"",""spending_outpoints"":[{""n"":0,""tx_index"":4748021854014319}],""spent"":true,""tx_index"":463608248045841,""type"":0,""value"":36743}}]","[{""type"":0,""spent"":false,""value"":2220,""spending_outpoints"":[],""n"":0,""tx_index"":4748021854014319,""script"":""76a914a0b0d60e5991578ed37cbda2b17d8b2ce23ab29588ac"",""addr"":""1FeexV6bAHb8ybZjqQMjJrcCrHGW9sb6uF""},{""type"":0,""spent"":true,""value"":33227,""spending_outpoints"":[{""tx_index"":5110751045852555,""n"":0}],""n"":1,""tx_index"":4748021854014319,""script"":""00140118877f443afbf9c82e4ace8be34e8711c348a7"",""addr"":""bc1qqyvgwl6y8talnjpwft8ghc6wsuguxj98ejl2rh""}]",2220,7995726053087
"eea2e7b9bd9918551481ad5b5fdc4219827bbfddda3477d7c471b7657ed765f3",1,1,2,226,574,2016,"0.0.0.0",0,8563799444207342,false,1691174852,801703,801703,"[{""sequence"":4294967293,""witness"":""02483045022100944480375c5c95e5b1b5af4cb764d926d33e671d07e067e97eb346cb6a3d1126022052a4461f7a4f372f382d61fb1b91f05819176b6b810f6e5e5c5127e207453e74012103a0abd1fca073da401e3d2bd5fa98bd12df3bc0e374f0bb8a5ba537e7b1c930b9"",""script"":"""",""index"":0,""prev_out"":{""addr"":""bc1qq5arl0qzgps7fkgm72eq5nj7mt7mq9hpvhe8w9"",""n"":1,""script"":""0014053a3fbc024061e4d91bf2b20a4e5edafdb016e1"",""spending_outpoints"":[{""n"":0,""tx_index"":8563799444207342}],""spent"":true,""tx_index"":6844976621093202,""type"":0,""value"":19531}}]","[{""type"":0,""spent"":false,""value"":2222,""spending_outpoints"":[],""n"":0,""tx_index"":8563799444207342,""script"":""76a914a0b0d60e5991578ed37cbda2b17d8b2ce23ab29588ac"",""addr"":""1FeexV6bAHb8ybZjqQMjJrcCrHGW9sb6uF""},{""type"":0,""spent"":true,""value"":15293,""spending_outpoints"":[{""tx_index"":3072896832826124,""n"":0}],""n"":1,""tx_index"":8563799444207342,""script"":""001401ceb5e1e31be66d8629b1aa3369aeb065a2cb2b"",""addr"":""bc1qq88ttc0rr0nxmp3fkx4rx6dwkpj69jet4ug8pz""}]",2222,7995726050867
"5abb785bbadb6f1cb0a1a479f8d34396f829f5915e33c0d3f0930af87fc28bc2",1,1,2,225,573,2016,"0.0.0.0",0,6844976621093202,false,1691174824,801703,801703,"[{""sequence"":4294967293,""witness"":""024730440220134aed8cf3d5048f951b5037bb6d9aa13b98953f38139d5915a635c203ba237002202e47748d5d4888ae0939cd23b06fa71f80004b71154bf68ee61f5eb418c4af46012102552f875f7dddfb402c9fe2c0213177e730a9364ae004bf896068212eb1e7049f"",""script"":"""",""index"":0,""prev_out"":{""addr"":""bc1q5698f8h9gy4m7cum9008elwwdzc26z3fyur2yq"",""n"":79,""script"":""0014a68a749ee5412bbf639b2bde7cfdce68b0ad0a29"",""spending_outpoints"":[{""n"":0,""tx_index"":6844976621093202}],""spent"":true,""tx_index"":1559327433375680,""type"":0,""value"":22658}}]","[{""type"":0,""spent"":false,""value"":1111,""spending_outpoints"":[],""n"":0,""tx_index"":6844976621093202,""script"":""76a914a0b0d60e5991578ed37cbda2b17d8b2ce23ab29588ac"",""addr"":""1FeexV6bAHb8ybZjqQMjJrcCrHGW9sb6uF""},{""type"":0,""spent"":true,""value"":19531,""spending_outpoints"":[{""tx_index"":8563799444207342,""n"":0}],""n"":1,""tx_index"":6844976621093202,""script"":""0014053a3fbc024061e4d91bf2b20a4e5edafdb016e1"",""addr"":""bc1qq5arl0qzgps7fkgm72eq5nj7mt7mq9hpvhe8w9""}]",1111,7995726048645
"8e6fb6eb1d7846356b0dd777cf00421cb60282d0282043a91de55829607824dc",1,1,2,225,573,864,"0.0.0.0",0,7745574288042780,false,1690081376,799852,799852,"[{""sequence"":4294967293,""witness"":""0247304402201ac127295ec3d51c252b64c7f2cd3c9599e002504d31206f92799c0321676a8e022004d4c0a32bc295ead010448f9264fbd088889510b113dc934d70637048339cdc01210345268fa2a5cfb09a25035f50e5fdd3e0fe52b38edebc4d743063a47b87563a48"",""script"":"""",""index"":0,""prev_out"":{""addr"":""bc1qsrhy996mt8lc2kscyksc7mrqz6wg2x5fx9gada"",""n"":1,""script"":""001480ee42975b59ff855a1825a18f6c60169c851a89"",""spending_outpoints"":[{""n"":0,""tx_index"":7745574288042780}],""spent"":true,""tx_index"":7680178918252672,""type"":0,""value"":7749}}]","[{""type"":0,""spent"":true,""value"":986,""spending_outpoints"":[{""tx_index"":8588121649290065,""n"":0}],""n"":0,""tx_index"":7745574288042780,""script"":""00144d47c584cbe0f192b5bcd952efcc288d6baccf86"",""addr"":""bc1qf4rutpxturce9ddum9fwlnpg3446enux69mxjv""},{""type"":0,""spent"":false,""value"":5899,""spending_outpoints"":[],""n"":1,""tx_index"":7745574288042780,""script"":""76a914a0b0d60e5991578ed37cbda2b17d8b2ce23ab29588ac"",""addr"":""1FeexV6bAHb8ybZjqQMjJrcCrHGW9sb6uF""}]",5899,7995726047534
"51d41021d4b364c27e0db1305351a114bbd4767e122e2558620304df01a848da",1,1,2,225,573,7344,"0.0.0.0",0,7680178918252672,false,1690081342,799850,799850,"[{""sequence"":4294967293,""witness"":""02473044022036ae265dd361092aaa36533d07687246576e7face26377f720576f299ed602c402203f4cc930238dddf3c26df7965eb7d12ce765036a3eb121e677d4c02c33f02469012102105f0051c18cf9ed2c9f60702942e0daf9511c68bec20b4dbd29050d1db483f2"",""script"":"""",""index"":0,""prev_out"":{""addr"":""bc1q4330mwpjt8yez3xrcctnedjwkdtagmg4ela2nt"",""n"":1,""script"":""0014ac62fdb83259c99144c3c6173cb64eb357d46d15"",""spending_outpoints"":[{""n"":0,""tx_index"":7680178918252672}],""spent"":true,""tx_index"":6268613374035841,""type"":0,""value"":17313}}]","[{""type"":0,""spent"":false,""value"":2220,""spending_outpoints"":[],""n"":0,""tx_index"":7680178918252672,""script"":""76a914a0b0d60e5991578ed37cbda2b17d8b2ce23ab29588ac"",""addr"":""1FeexV6bAHb8ybZjqQMjJrcCrHGW9sb6uF""},{""type"":0,""spent"":true,""value"":7749,""spending_outpoints"":[{""tx_index"":7745574288042780,""n"":0}],""n"":1,""tx_index"":7680178918252672,""script"":""001480ee42975b59ff855a1825a18f6c60169c851a89"",""addr"":""bc1qsrhy996mt8lc2kscyksc7mrqz6wg2x5fx9gada""}]",2220,7995726041635
"e43449147e3d0da04f6a31623e6c83fdea3f59c7e7c33c02a20d3c264b2a2ab2",1,1,2,226,574,7344,"0.0.0.0",0,6268613374035841,false,1690081314,799850,799850,"[{""sequence"":4294967293,""witness"":""02483045022100f903d1366c99d26de15f5af77f8a5566cda29dac22dc0878767d71f256928f050220482ea96a4030a7cb08fa0a3b5b22a90affa6edd7cffd9547e8980479e28d3c5401210213c3b47f93d63821a15aa758711e4bc62ea48fc3ee9f5625c5b01b501c9e14f4"",""script"":"""",""index"":0,""prev_out"":{""addr"":""bc1qwsrljq08xhlsy7m58fyx9c9kffe6vucxlcsm9h"",""n"":201,""script"":""00147407f901e735ff027b743a4862e0b64a73a67306"",""spending_outpoints"":[{""n"":0,""tx_index"":6268613374035841}],""spent"":true,""tx_index"":2712811459158068,""type"":0,""value"":26008}}]","[{""type"":0,""spent"":false,""value"":1351,""spending_outpoints"":[],""n"":0,""tx_index"":6268613374035841,""script"":""76a914a0b0d60e5991578ed37cbda2b17d8b2ce23ab29588ac"",""addr"":""1FeexV6bAHb8ybZjqQMjJrcCrHGW9sb6uF""},{""type"":0,""spent"":true,""value"":17313,""spending_outpoints"":[{""tx_index"":7680178918252672,""n"":0}],""n"":1,""tx_index"":6268613374035841,""script"":""0014ac62fdb83259c99144c3c6173cb64eb357d46d15"",""addr"":""bc1q4330mwpjt8yez3xrcctnedjwkdtagmg4ela2nt""}]",1351,7995726039415
"eef445d4797a337ba7cd4d4a6aaab971cdf7c9a82a85b076f0b859557e32e180",1,1,1,194,449,5180,"0.0.0.0",0,4534550500387639,false,1689901918,799596,799596,"[{""sequence"":4294967293,""witness"":""02473044022056e7b9967e12a555337af61e045cf4e5cb1e969bda9fb8697bbce336256a248c022021c0a4e7d2ccdd1446d80b62d8d4952b5694e32c534ea2abcca5d15a8ae846c60121028047fb2395691d1132c1c61432ac5576679712282f2133bc6256d625f18006f6"",""script"":"""",""index"":0,""prev_out"":{""addr"":""bc1q3wxvt2h8qe4vn8lrecm7p8z9vugjcqkkkf4vlt"",""n"":0,""script"":""00148b8cc5aae7066ac99fe3ce37e09c4567112c02d6"",""spending_outpoints"":[{""n"":0,""tx_index"":4534550500387639}],""spent"":true,""tx_index"":5411453369648547,""type"":0,""value"":7402}}]","[{""type"":0,""spent"":false,""value"":2222,""spending_outpoints"":[],""n"":0,""tx_index"":4534550500387639,""script"":""76a914a0b0d60e5991578ed37cbda2b17d8b2ce23ab29588ac"",""addr"":""1FeexV6bAHb8ybZjqQMjJrcCrHGW9sb6uF""}]",2222,7995726038064
"7d0a46acb3e36916e40698d9c37561962cebad40d4c5416eee1c2d885e81cd99",1,1,2,226,574,1584,"0.0.0.0",0,5411453369648547,false,1689640028,799154,799154,"[{""sequence"":4294967293,""witness"":""02483045022100d13c11be049aea1ab2d68823e8da210538daab38d8a11d2d3ea40db609e9a0bb022057c00108ac648fb2184f63a056a752e01c9161165177cab2d3dc3fd9216e710a0121031557db626be6230d9c21e08f8e755cbf9b2e02e8bd3ce37cf6677c4989d3ee03"",""script"":"""",""index"":0,""prev_out"":{""addr"":""bc1qsfwfyasjwdy79mudrltmclq7xxkzle3jgfaeh5"",""n"":1,""script"":""0014825c9276127349e2ef8d1fd7bc7c1e31ac2fe632"",""spending_outpoints"":[{""n"":0,""tx_index"":5411453369648547}],""spent"":true,""tx_index"":8255191210277612,""type"":0,""value"":34885}}]","[{""type"":0,""spent"":true,""value"":7402,""spending_outpoints"":[{""tx_index"":4534550500387639,""n"":0}],""n"":0,""tx_index"":5411453369648547,""script"":""00148b8cc5aae7066ac99fe3ce37e09c4567112c02d6"",""addr"":""bc1q3wxvt2h8qe4vn8lrecm7p8z9vugjcqkkkf4vlt""},{""type"":0,""spent"":false,""value"":25899,""spending_outpoints"":[],""n"":1,""tx_index"":5411453369648547,""script"":""76a914a0b0d60e5991578ed37cbda2b17d8b2ce23ab29588ac"",""addr"":""1FeexV6bAHb8ybZjqQMjJrcCrHGW9sb6uF""}]",25899,7995726035842
"763b70fa619e227ba7d79ff691a3ced3467210288bb38dbd5c64d721dd6ba0ea",1,1,2,225,573,1584,"0.0.0.0",0,8255191210277612,false,1689639993,799154,799154,"[{""sequence"":4294967293,""witness"":""0247304402201cf61c12d0850080d3991ffadb599e113ad25eb6a5723254d4d2ac894934e47902201926151115297e1b981cf82f5437689f8f34be9a8897aacbd757527a8241638b0121025f7aba3b9a57d2e2f5192eb8e8f7203e9f95d7e1490aebdc299d6f9d6b3f86bc"",""script"":"""",""index"":0,""prev_out"":{""addr"":""bc1q34ue2h0lx450xlwrgr92zrkffyfpxd3l8cdd4p"",""n"":1,""script"":""00148d79955dff3568f37dc340caa10ec9491213363f"",""spending_outpoints"":[{""n"":0,""tx_index"":8255191210277612}],""spent"":true,""tx_index"":8411520537947862,""type"":0,""value"":37820}}]","[{""type"":0,""spent"":false,""value"":1351,""spending_outpoints"":[],""n"":0,""tx_index"":8255191210277612,""script"":""76a914a0b0d60e5991578ed37cbda2b17d8b2ce23ab29588ac"",""addr"":""1FeexV6bAHb8ybZjqQMjJrcCrHGW9sb6uF""},{""type"":0,""spent"":true,""value"":34885,""spending_outpoints"":[{""tx_index"":5411453369648547,""n"":0}],""n"":1,""tx_index"":8255191210277612,""script"":""0014825c9276127349e2ef8d1fd7bc7c1e31ac2fe632"",""addr"":""bc1qsfwfyasjwdy79mudrltmclq7xxkzle3jgfaeh5""}]",1351,7995726009943
"8f116bfb7178337d4faaefaa2281a4ff0a8eab1a435a5ff0efb7767beddd11ef",1,1,2,225,573,2304,"0.0.0.0",0,8411520537947862,false,1689285922,798581,798581,"[{""sequence"":4294967293,""witness"":""0247304402201f29e958ba388eedf0ec3adad2cb46159c49e066b42ae4d215cb14fdee1d998202200b396c7cb285c21e69c58bf6c9f284768c07bfa7d63bc80b2ce6c83dc9820ff501210247720386097d99825a087def1747e21e74987ace8f0fc7976cabbb156be87cf2"",""script"":"""",""index"":0,""prev_out"":{""addr"":""bc1qa0x9elwd3deuglehqfvu96jxfxp5q0favqwvsn"",""n"":1,""script"":""0014ebcc5cfdcd8b73c47f370259c2ea464983403d3d"",""spending_outpoints"":[{""n"":0,""tx_index"":8411520537947862}],""spent"":true,""tx_index"":1202067097725235,""type"":0,""value"":46023}}]","[{""type"":0,""spent"":false,""value"":5899,""spending_outpoints"":[],""n"":0,""tx_index"":8411520537947862,""script"":""76a914a0b0d60e5991578ed37cbda2b17d8b2ce23ab29588ac"",""addr"":""1FeexV6bAHb8ybZjqQMjJrcCrHGW9sb6uF""},{""type"":0,""spent"":true,""value"":37820,""spending_outpoints"":[{""tx_index"":8255191210277612,""n"":0}],""n"":1,""tx_index"":8411520537947862,""script"":""00148d79955dff3568f37dc340caa10ec9491213363f"",""addr"":""bc1q34ue2h0lx450xlwrgr92zrkffyfpxd3l8cdd4p""}]",5899,7995726008592
"8a6d2905d886bd8924f8926348edfa70dd25065b24a61103e79d49d972302a22",1,1,2,226,574,2304,"0.0.0.0",0,1202067097725235,false,1689282393,798573,798573,"[{""sequence"":4294967293,""witness"":""02483045022100b2052c8f605ae297b2b65a748d7341f49923e8e016a708eaec11987e319393a5022019a164abe1111081f43a0418ddf4e1f83af01db0fc025dc8b763c24ba5633704012102c5e1aac734d8d9e75f70d44d650997a6511d0471a6c5a80bab3439243e278eda"",""script"":"""",""index"":0,""prev_out"":{""addr"":""bc1qtl0w57qmsgp6rkgrrhmt2p9udm95maht4j0j2g"",""n"":1,""script"":""00145fdeea781b8203a1d9031df6b504bc6ecb4df6eb"",""spending_outpoints"":[{""n"":0,""tx_index"":1202067097725235}],""spent"":true,""tx_index"":6446338730220511,""type"":0,""value"":50439}}]","[{""type"":0,""spent"":false,""value"":2112,""spending_outpoints"":[],""n"":0,""tx_index"":1202067097725235,""script"":""76a914a0b0d60e5991578ed37cbda2b17d8b2ce23ab29588ac"",""addr"":""1FeexV6bAHb8ybZjqQMjJrcCrHGW9sb6uF""},{""type"":0,""spent"":true,""value"":46023,""spending_outpoints"":[{""tx_index"":8411520537947862,""n"":0}],""n"":1,""tx_index"":1202067097725235,""script"":""0014ebcc5cfdcd8b73c47f370259c2ea464983403d3d"",""addr"":""bc1qa0x9elwd3deuglehqfvu96jxfxp5q0favqwvsn""}]",2112,7995726002693
"47d2f5c073473a4842999dc6221ac8ab5513362fae907713bbfadeee904937b7",1,1,2,226,574,1728,"0.0.0.0",0,6446338730220511,false,1688850504,797840,797840,"[{""sequence"":4294967293,""witness"":""02483045022100fc9a07c260d85c72a71ad2e6cccddbfeeba040e1daaac6f8f8b1a4c046ef0e9f02206e9be7d4df8d45c8ba3c2c199ddf4c400f9450e859eae1c79977c35054e3820f0121031f73a6f0ba2c0c7281c048239d71c40713dc5db336afe529b2508d8b8a237e4f"",""script"":"""",""index"":0,""prev_out"":{""addr"":""bc1q2jhphn8yaldj45xmcfxg8ucdut0c2pxz2jt9v5"",""n"":1,""script"":""001454ae1bcce4efdb2ad0dbc24c83f30de2df8504c2"",""spending_outpoints"":[{""n"":0,""tx_index"":6446338730220511}],""spent"":true,""tx_index"":2057867013782216,""type"":0,""value"":54389}}]","[{""type"":0,""spent"":false,""value"":2222,""spending_outpoints"":[],""n"":0,""tx_index"":6446338730220511,""script"":""76a914a0b0d60e5991578ed37cbda2b17d8b2ce23ab29588ac"",""addr"":""1FeexV6bAHb8ybZjqQMjJrcCrHGW9sb6uF""},{""type"":0,""spent"":true,""value"":50439,""spending_outpoints"":[{""tx_index"":1202067097725235,""n"":0}],""n"":1,""tx_index"":6446338730220511,""script"":""00145fdeea781b8203a1d9031df6b504bc6ecb4df6eb"",""addr"":""bc1qtl0w57qmsgp6rkgrrhmt2p9udm95maht4j0j2g""}]",2222,7995726000581
"c8a58ff6237be731d62c87ffe65b96ff76139c92d0d67aa85141d6cf02f47c3a",1,1,2,225,573,1728,"0.0.0.0",0,2057867013782216,false,1688758085,797655,797655,"[{""sequence"":4294967293,""witness"":""0247304402204070ed373f375daadfbb4a09d2e0e33977ec5b08307fb3969b5400aaeb1396f1022024275f16a0edcf5929bcc4e662b9670bfc536bb88c2772fb96ab45447860c8510121034c8a64f6fb3d77feb59d0aa3b091c26e05f3d31a2473b2572899803d279bd803"",""script"":"""",""index"":0,""prev_out"":{""addr"":""bc1qre4d9xe7wm0a60rv03eqe3t87jgwqqasw3pj95"",""n"":1,""script"":""00141e6ad29b3e76dfdd3c6c7c720cc567f490e003b0"",""spending_outpoints"":[{""n"":0,""tx_index"":2057867013782216}],""spent"":true,""tx_index"":2204861853569222,""type"":0,""value"":71737}}]","[{""type"":0,""spent"":false,""value"":15620,""spending_outpoints"":[],""n"":0,""tx_index"":2057867013782216,""script"":""76a914a0b0d60e5991578ed37cbda2b17d8b2ce23ab29588ac"",""addr"":""1FeexV6bAHb8ybZjqQMjJrcCrHGW9sb6uF""},{""type"":0,""spent"":true,""value"":54389,""spending_outpoints"":[{""tx_index"":6446338730220511,""n"":0}],""n"":1,""tx_index"":2057867013782216,""script"":""001454ae1bcce4efdb2ad0dbc24c83f30de2df8504c2"",""addr"":""bc1q2jhphn8yaldj45xmcfxg8ucdut0c2pxz2jt9v5""}]",15620,7995725998359
"cdc631a540287b57163cb7a09e518e6b7720afad14b5f0078884d0c466c4b3c3",2,1,2,225,900,5725,"0.0.0.0",0,6885659572214288,false,1688701277,797530,797530,"[{""sequence"":4294967295,""witness"":"""",""script"":""473044022007be27f24aa75379322469a8727a30237a94a5a824a37af97cfb703ac1158d77022022bfb1ee74d47b59483a471610317b9ffa8c939cfdc4c30d9699733c021dd82c0121028fe7df4e5a8e6fd676e448c000d5d46861cae5fedd8ca3176a73fc9eefe36b1d"",""index"":0,""prev_out"":{""addr"":""1JeHb74qmgVYgw3Pc7At7TeWrNKySgnJAe"",""n"":1,""script"":""76a914c1876039eed3bf7da63455d5b148b1c75d5a096688ac"",""spending_outpoints"":[{""n"":0,""tx_index"":6885659572214288}],""spent"":true,""tx_index"":6689966518757797,""type"":0,""value"":473082}}]","[{""type"":0,""spent"":false,""value"":89000,""spending_outpoints"":[],""n"":0,""tx_index"":6885659572214288,""script"":""76a914a0b0d60e5991578ed37cbda2b17d8b2ce23ab29588ac"",""addr"":""1FeexV6bAHb8ybZjqQMjJrcCrHGW9sb6uF""},{""type"":0,""spent"":true,""value"":378357,""spending_outpoints"":[{""tx_index"":6012209397966539,""n"":0}],""n"":1,""tx_index"":6885659572214288,""script"":""76a9144558ea1f631a0d950ed964ce1998300f6fa6fcc088ac"",""addr"":""17Kg98N38qnTd4sg13C89oUx6QAyBghixU""}]",89000,7995725982739
"224ed3d0f1d8c62dfb10065038b21e02e1a5fcdd868129443a8de9484f9030b1",1,1,2,248,665,3718,"0.0.0.0",0,6234308405173553,false,1688192021,796661,796661,"[{""sequence"":0,""witness"":""0247304402206b9c8cdb384392322053e5a4e91f36ee7958f89f89a929214c280b19b8fa5d9102206ea8e523e527ffd67ef870c69083582587336e36ff8821d7944bcb4e2d39f34c01210259dcd9004d3c883193efc9e6ae72587fd120ecd2dc3efd9de25b736ba7040b5a"",""script"":""160014abff3697be4b8f16f57915ce547c8da7662a57bd"",""index"":0,""prev_out"":{""addr"":""384YVAq4ntx3vE4NeMeTUkVvrDX9asvEXh"",""n"":0,""script"":""a91445e30090fd841de5dd3ec61831b4467cd4ceb88687"",""spending_outpoints"":[{""n"":0,""tx_index"":6234308405173553}],""spent"":true,""tx_index"":4438667753761617,""type"":0,""value"":292221}}]","[{""type"":0,""spent"":false,""value"":284716,""spending_outpoints"":[],""n"":0,""tx_index"":6234308405173553,""script"":""76a914a0b0d60e5991578ed37cbda2b17d8b2ce23ab29588ac"",""addr"":""1FeexV6bAHb8ybZjqQMjJrcCrHGW9sb6uF""},{""type"":0,""spent"":false,""value"":3787,""spending_outpoints"":[],""n"":1,""tx_index"":6234308405173553,""script"":""001478122e233e60e9051ad810e56c6366cefe424cfb"",""addr"":""bc1q0qfzuge7vr5s2xkczrjkccmxemlyyn8mhx298v""}]",284716,7995725893739
"e9d22a925b32c63f06b309952ab140753bcecf37d1f764659032867c3c7baa3e",1,1,2,225,573,5040,"0.0.0.0",0,2204861853569222,false,1687549908,795614,795614,"[{""sequence"":4294967293,""witness"":""0247304402206407bca8307499f8d1d8ba77c924e0dfdc66323eeaef64765e771765b32f7cd7022019d615fb80c6c9c537e5146a4d85dfb6e4c966f23b41c8a23d97283446c5a1d6012103d102bbe598971cca8c93f0d82f10bbb0e158768f1f9f7a7da00c3da4458e50f4"",""script"":"""",""index"":0,""prev_out"":{""addr"":""bc1qfrg9xefjnha8ypk8kc5vvxpjyxppzkayy25j74"",""n"":133,""script"":""001448d05365329dfa7206c7b628c618322182115ba4"",""spending_outpoints"":[{""n"":0,""tx_index"":2204861853569222}],""spent"":true,""tx_index"":5587469081784235,""type"":0,""value"":78997}}]","[{""type"":0,""spent"":false,""value"":2220,""spending_outpoints"":[],""n"":0,""tx_index"":2204861853569222,""script"":""76a914a0b0d60e5991578ed37cbda2b17d8b2ce23ab29588ac"",""addr"":""1FeexV6bAHb8ybZjqQMjJrcCrHGW9sb6uF""},{""type"":0,""spent"":true,""value"":71737,""spending_outpoints"":[{""tx_index"":2057867013782216,""n"":0}],""n"":1,""tx_index"":2204861853569222,""script"":""00141e6ad29b3e76dfdd3c6c7c720cc567f490e003b0"",""addr"":""bc1qre4d9xe7wm0a60rv03eqe3t87jgwqqasw3pj95""}]",2220,7995725609023
"0ee9c2076563e39175e646872934e684e8669fef1112ae50aaddc865739bf3fa",1,1,1,194,449,3166,"0.0.0.0",0,8829574144899355,false,1687538256,795599,795599,"[{""sequence"":4294967293,""witness"":""024730440220659d5593d924eef4ccc72feb2d3ef36d03f32d7b803ed6522653e309273a567b02200f5cfe10814d282f7b631acbf8e560659814c6e8b9de630d78368278ec7fca97012103d17c82d165f627d9448e71fb27327b4d2b8316bdf48de52c9cf9c50232eb03d7"",""script"":"""",""index"":0,""prev_out"":{""addr"":""bc1q8kcer04l3t548p24wp0uqs9uq9ms6jz2rf39zv"",""n"":1,""script"":""00143db191bebf8ae9538555705fc040bc01770d484a"",""spending_outpoints"":[{""n"":0,""tx_index"":8829574144899355}],""spent"":true,""tx_index"":5877093752508869,""type"":0,""value"":29065}}]","[{""type"":0,""spent"":false,""value"":25899,""spending_outpoints"":[],""n"":0,""tx_index"":8829574144899355,""script"":""76a914a0b0d60e5991578ed37cbda2b17d8b2ce23ab29588ac"",""addr"":""1FeexV6bAHb8ybZjqQMjJrcCrHGW9sb6uF""}]",25899,7995725606803
"e7a052955d545d0f6fd002a75ce87aacf8183233fca2fbe1fe00b834cafa640c",1,1,1,192,768,3840,"0.0.0.0",0,436091002197760,false,1687503919,795551,795551,"[{""sequence"":4294967295,""witness"":"""",""script"":""483045022100f517b3cd0431bec25e1989899c78725fc83379a351e54dd6fd68d479bf9d87180220185139442c5be1121d17cb53274eeec3e9461e474a9d32663702616bbf271c99012102d3729810e78433412541f8c99621173733aa2156262e8a77943436d877a4ebda"",""index"":0,""prev_out"":{""addr"":""14tuBU19AoBma5d1NZvwgUKkyCLMn3ThPi"",""n"":198,""script"":""76a9142ab92641c2246e0683621bf55521be032ad7a2b288ac"",""spending_outpoints"":[{""n"":0,""tx_index"":436091002197760}],""spent"":true,""tx_index"":3933291171350689,""type"":0,""value"":5519}}]","[{""type"":0,""spent"":false,""value"":1679,""spending_outpoints"":[],""n"":0,""tx_index"":436091002197760,""script"":""76a914a0b0d60e5991578ed37cbda2b17d8b2ce23ab29588ac"",""addr"":""1FeexV6bAHb8ybZjqQMjJrcCrHGW9sb6uF""}]",1679,7995725580904
"584ebaee0666617d5dfa1446e4edcff2aff27c379c2603aafb355d22c489f090",1,2,1,343,721,6649,"0.0.0.0",0,5099608892263334,false,1687470887,795496,795496,"[{""sequence"":4294967293,""witness"":""02483045022100aee5f868931cca97bdf3449dbd61769e71d946729ac6259ab36b06b9fcc73164022070253cf0c95a891d34581d7acd1bb603a89a975e6796f2e2c41ea5ec1194b0ce01210383d7e8252160843d5e0797379d6fc4fd9fc1ef347ba7dd2108246b9599e0a22d"",""script"":"""",""index"":0,""prev_out"":{""addr"":""bc1qszg287cyqdn5t3jv35p0es5npr3zvhzkp0kwge"",""n"":1,""script"":""00148090a3fb04036745c64c8d02fcc29308e2265c56"",""spending_outpoints"":[{""n"":0,""tx_index"":5099608892263334}],""spent"":true,""tx_index"":1063752314995491,""type"":0,""value"":24315}},{""sequence"":4294967293,""witness"":""024730440220170a54626b19cb1d05310e4e42bc7b1382112686852b8eeab02f993d63a6371702203b94c810908fe9bc0235da7b935a1f70779b90a68686eb2dcbf8c46838eb53db012102f831dfde69551973dcebdcb4c4d047ccc0595d67683ab459d186107a105725bf"",""script"":"""",""index"":1,""prev_out"":{""addr"":""bc1qcy4g4y798tmndqg7cqj637t5h90sw5ngumtstq"",""n"":0,""script"":""0014c12a8a93c53af736811ec025a8f974b95f075268"",""spending_outpoints"":[{""n"":1,""tx_index"":5099608892263334}],""spent"":true,""tx_index"":7514011336705779,""type"":0,""value"":8233}}]","[{""type"":0,""spent"":false,""value"":25899,""spending_outpoints"":[],""n"":0,""tx_index"":5099608892263334,""script"":""76a914a0b0d60e5991578ed37cbda2b17d8b2ce23ab29588ac"",""addr"":""1FeexV6bAHb8ybZjqQMjJrcCrHGW9sb6uF""}]",25899,7995725579225
"db50de68ff0ac8f9ded37901cf2776b766d6a48d09f7bb0fa876a8056a23c45c",1,1,1,195,450,4243,"0.0.0.0",0,3263919279879438,false,1687470872,795496,795496,"[{""sequence"":4294967293,""witness"":""02483045022100b29f68d9d1b151693043d946e499f01347a70d749bfc32ca7a0602c337470deb0220635aff46c7c326f98e77b4e83bc8582b9a6966815dd226aac189e0f196a4de43012102c4e1c49dc83f5433a730f381bfc1b4ddadf427b8a541270857cc53c56ab21b40"",""script"":"""",""index"":0,""prev_out"":{""addr"":""bc1qy2ng2y57fggcue5g4tthdgftt6dr8t48ysea3m"",""n"":0,""script"":""001422a685129e4a118e6688aad776a12b5e9a33aea7"",""spending_outpoints"":[{""n"":0,""tx_index"":3263919279879438}],""spent"":true,""tx_index"":3679144496647066,""type"":0,""value"":6463}}]","[{""type"":0,""spent"":false,""value"":2220,""spending_outpoints"":[],""n"":0,""tx_index"":3263919279879438,""script"":""76a914a0b0d60e5991578ed37cbda2b17d8b2ce23ab29588ac"",""addr"":""1FeexV6bAHb8ybZjqQMjJrcCrHGW9sb6uF""}]",2220,7995725553326
"623e414069dc1e2e5a9b1b1d2ee444b5e6bff406fae36a5d65298e702b7c09a7",1,1,2,226,574,4464,"0.0.0.0",0,5877093752508869,false,1687467057,795494,795494,"[{""sequence"":4294967293,""witness"":""024830450221008ecfc88cb9cb894c265f3e492bfea646e3a3da4a59d2fe24ae18956c4a486b2c02206ee68f3018c99a03b2ece67a4c28540418ab91e77d526e533b419f9b567f1e240121029797227b4ffbf81e94861dde8703343572eb8afdac73027c3f3bf9bf838fcce9"",""script"":"""",""index"":0,""prev_out"":{""addr"":""bc1qu9krm0t2ctd72jvmhd075vxj5n06djufqj4urq"",""n"":1,""script"":""0014e16c3dbd6ac2dbe5499bbb5fea30d2a4dfa6cb89"",""spending_outpoints"":[{""n"":0,""tx_index"":5877093752508869}],""spent"":true,""tx_index"":5229648661138118,""type"":0,""value"":35749}}]","[{""type"":0,""spent"":false,""value"":2220,""spending_outpoints"":[],""n"":0,""tx_index"":5877093752508869,""script"":""76a914a0b0d60e5991578ed37cbda2b17d8b2ce23ab29588ac"",""addr"":""1FeexV6bAHb8ybZjqQMjJrcCrHGW9sb6uF""},{""type"":0,""spent"":true,""value"":29065,""spending_outpoints"":[{""tx_index"":8829574144899355,""n"":0}],""n"":1,""tx_index"":5877093752508869,""script"":""00143db191bebf8ae9538555705fc040bc01770d484a"",""addr"":""bc1q8kcer04l3t548p24wp0uqs9uq9ms6jz2rf39zv""}]",2220,7995725551106
"67a39017e8e5e30f62830e5917872fc454bec18bc3765bdd12d35c66a64c9168",1,1,2,226,574,4464,"0.0.0.0",0,3679144496647066,false,1687467189,795494,795494,"[{""sequence"":4294967293,""witness"":""02483045022100f69d7b0930ef4b9e58cc2ed9e233001fa3e41929ef41189a74db2552ef6946be022025b7df07624dc34412d3f8300d74dafbb05e3bd2b53be7101f9b61c9179ad575012102d6b2a9574da006cf0da79853a0651e0bffe77ec567a4d6a0974cc572ea8f034b"",""script"":"""",""index"":0,""prev_out"":{""addr"":""bc1q90as78c2t6r406yg285nx6qlga7qxn58ueq47u"",""n"":92,""script"":""00142bfb0f1f0a5e8757e88851e933681f477c034e87"",""spending_outpoints"":[{""n"":0,""tx_index"":3679144496647066}],""spent"":true,""tx_index"":7189077889363299,""type"":0,""value"":35200}}]","[{""type"":0,""spent"":true,""value"":6463,""spending_outpoints"":[{""tx_index"":3263919279879438,""n"":0}],""n"":0,""tx_index"":3679144496647066,""script"":""001422a685129e4a118e6688aad776a12b5e9a33aea7"",""addr"":""bc1qy2ng2y57fggcue5g4tthdgftt6dr8t48ysea3m""},{""type"":0,""spent"":false,""value"":24273,""spending_outpoints"":[],""n"":1,""tx_index"":3679144496647066,""script"":""76a914a0b0d60e5991578ed37cbda2b17d8b2ce23ab29588ac"",""addr"":""1FeexV6bAHb8ybZjqQMjJrcCrHGW9sb6uF""}]",24273,7995725548886
"7b154342f5de4fa7fbf836ea7c605fb5a5618b9475945bc18c9b3780c4a08fd5",1,1,2,225,573,3744,"0.0.0.0",0,7514011336705779,false,1687310030,795257,795257,"[{""sequence"":4294967293,""witness"":""0247304402200efd5af5e445fe11892c2ab197ee3342cd2357d05d315856109e80bb2787932e022019b8e82d4274bc1bcd7fa7e1a3f3a7a4a3890de988f6ec618bdefc7d174a0cc3012103802688e3cd81b7f4b4216e61201d70bc1f9bc26e41d712c8a3e55b220675925e"",""script"":"""",""index"":0,""prev_out"":{""addr"":""bc1qyfxvtt5m8ctrtpcrytmfqux5pt2vk2qdwk362t"",""n"":1,""script"":""0014224cc5ae9b3e1635870322f69070d40ad4cb280d"",""spending_outpoints"":[{""n"":0,""tx_index"":7514011336705779}],""spent"":true,""tx_index"":3538203539574243,""type"":0,""value"":37876}}]","[{""type"":0,""spent"":true,""value"":8233,""spending_outpoints"":[{""tx_index"":5099608892263334,""n"":1}],""n"":0,""tx_index"":7514011336705779,""script"":""0014c12a8a93c53af736811ec025a8f974b95f075268"",""addr"":""bc1qcy4g4y798tmndqg7cqj637t5h90sw5ngumtstq""},{""type"":0,""spent"":false,""value"":25899,""spending_outpoints"":[],""n"":1,""tx_index"":7514011336705779,""script"":""76a914a0b0d60e5991578ed37cbda2b17d8b2ce23ab29588ac"",""addr"":""1FeexV6bAHb8ybZjqQMjJrcCrHGW9sb6uF""}]",25899,7995725524613
"77159555d279c8f904803457d7babe836e8098dc1552a186633756fab5b3a294",1,1,2,225,573,3744,"0.0.0.0",0,5229648661138118,false,1687309988,795257,795257,"[{""sequence"":4294967293,""witness"":""0247304402201fba9fdf31ddbd1476ee5b0d5e71fe2da8a70a5ec818518c6cb64bacfa45a33f02201f51aba0d723f664f929b0f2dcc6d825463ea5b1543b5be7e721579a3e20e5cf01210299a808f3ecb90a1d2c2140eb9fd0cd1127cc340f30783d80c149234b810dcd17"",""script"":"""",""index"":0,""prev_out"":{""addr"":""bc1q69mgf27d0s6m772fajw550k2d4kqj0vs7hh69v"",""n"":177,""script"":""0014d17684abcd7c35bf7949ec9d4a3eca6d6c093d90"",""spending_outpoints"":[{""n"":0,""tx_index"":5229648661138118}],""spent"":true,""tx_index"":6308688655675352,""type"":0,""value"":40844}}]","[{""type"":0,""spent"":false,""value"":1351,""spending_outpoints"":[],""n"":0,""tx_index"":5229648661138118,""script"":""76a914a0b0d60e5991578ed37cbda2b17d8b2ce23ab29588ac"",""addr"":""1FeexV6bAHb8ybZjqQMjJrcCrHGW9sb6uF""},{""type"":0,""spent"":true,""value"":35749,""spending_outpoints"":[{""tx_index"":5877093752508869,""n"":0}],""n"":1,""tx_index"":5229648661138118,""script"":""0014e16c3dbd6ac2dbe5499bbb5fea30d2a4dfa6cb89"",""addr"":""bc1qu9krm0t2ctd72jvmhd075vxj5n06djufqj4urq""}]",1351,7995725498714
"0a48e5b5772b6b9ba5067b123657e1a7fbbe6f7d3eb16fe8781df1f0e029445c",2,1,2,226,574,3347,"0.0.0.0",0,3246330564451875,false,1687208798,795103,795103,"[{""sequence"":0,""witness"":""02483045022100edb4f495d6cb9be8a750fe0906b42f9665b974d0804cd5e2c6e572b7d823a62602206e281e1d0a6455fe44bce1af14440ddc50960c2d4b523c0cfe5a8efc6f0648cd0121036c99982294ca7b0ee80f2400da2c8ac66211607c9ca1bb3a25a9593bff9708ed"",""script"":"""",""index"":0,""prev_out"":{""addr"":""bc1qdp768hqc402wda3q2p6e2w4nhek8xmrm8jdpha"",""n"":0,""script"":""0014687da3dc18abd4e6f6205075953ab3be6c736c7b"",""spending_outpoints"":[{""n"":0,""tx_index"":3246330564451875}],""spent"":true,""tx_index"":6147279771865796,""type"":0,""value"":2203400}}]","[{""type"":0,""spent"":false,""value"":77777,""spending_outpoints"":[],""n"":0,""tx_index"":3246330564451875,""script"":""76a914a0b0d60e5991578ed37cbda2b17d8b2ce23ab29588ac"",""addr"":""1FeexV6bAHb8ybZjqQMjJrcCrHGW9sb6uF""},{""type"":0,""spent"":true,""value"":2122276,""spending_outpoints"":[{""tx_index"":6195416402250853,""n"":0}],""n"":1,""tx_index"":3246330564451875,""script"":""00140d723ddb0bf0c562232636bedc6cf468bb5ba9cc"",""addr"":""bc1qp4ermkct7rzkygexx6ldcm85dza4h2wv9jgeem""}]",77777,7995725497363
"58c5e7ef46436d8244010eb9e9e13bbf2ad19448124bb98d4a1e6ff4a8d18f64",1,1,2,225,573,2736,"0.0.0.0",0,3538203539574243,false,1687190938,795082,795082,"[{""sequence"":4294967293,""witness"":""0247304402207193fdd9030115c84d2cea3c2b546701b7e1689322d759b359271c5c636697c402202b542fd2ef517be2711cdfbb713af6422d0d856ec12d03ac97bb428ced075f21012102367db4728f443b5eeead1e65112e69c306a072c834d68888765d002e087672fa"",""script"":"""",""index"":0,""prev_out"":{""addr"":""bc1qkzw3weutc03w565ud0uqjl4z3kansst02wzp6v"",""n"":1,""script"":""0014b09d17678bc3e2ea6a9c6bf8097ea28dbb38416f"",""spending_outpoints"":[{""n"":0,""tx_index"":3538203539574243}],""spent"":true,""tx_index"":7952743442812880,""type"":0,""value"":66511}}]","[{""type"":0,""spent"":false,""value"":25899,""spending_outpoints"":[],""n"":0,""tx_index"":3538203539574243,""script"":""76a914a0b0d60e5991578ed37cbda2b17d8b2ce23ab29588ac"",""addr"":""1FeexV6bAHb8ybZjqQMjJrcCrHGW9sb6uF""},{""type"":0,""spent"":true,""value"":37876,""spending_outpoints"":[{""tx_index"":7514011336705779,""n"":0}],""n"":1,""tx_index"":3538203539574243,""script"":""0014224cc5ae9b3e1635870322f69070d40ad4cb280d"",""addr"":""bc1qyfxvtt5m8ctrtpcrytmfqux5pt2vk2qdwk362t""}]",25899,7995725419586
"c75c5cacad6066eb5083a2856fc8c3025152e6fa2111cbba87827e30ffd207e2",1,1,2,226,574,2880,"0.0.0.0",0,7952743442812880,false,1687123631,794954,794954,"[{""sequence"":4294967293,""witness"":""02483045022100a7a2eaff0a994d2688dd759d0840c6635110b4c31a076e9ee71323fe3385e270022020c0fc57541294803582339ffc36cf396157e9aceb46ffd52bac4720ee867b620121037d1b8482829ff7d46dcf8dd98dec666ec91759112568d008d4d67573bc15a20d"",""script"":"""",""index"":0,""prev_out"":{""addr"":""bc1q8yke9pnruud9nsjxmtmh7tx5jy90ylvkd7504m"",""n"":19,""script"":""0014392d928663e71a59c246daf77f2cd4910af27d96"",""spending_outpoints"":[{""n"":0,""tx_index"":7952743442812880}],""spent"":true,""tx_index"":2811348397144133,""type"":0,""value"":70742}}]","[{""type"":0,""spent"":false,""value"":1351,""spending_outpoints"":[],""n"":0,""tx_index"":7952743442812880,""script"":""76a914a0b0d60e5991578ed37cbda2b17d8b2ce23ab29588ac"",""addr"":""1FeexV6bAHb8ybZjqQMjJrcCrHGW9sb6uF""},{""type"":0,""spent"":true,""value"":66511,""spending_outpoints"":[{""tx_index"":3538203539574243,""n"":0}],""n"":1,""tx_index"":7952743442812880,""script"":""0014b09d17678bc3e2ea6a9c6bf8097ea28dbb38416f"",""addr"":""bc1qkzw3weutc03w565ud0uqjl4z3kansst02wzp6v""}]",1351,7995725393687
"cda13f3b187f2f7a3e78e8b43d5c9688fd77f2e4ddf632280a754460bb81c890",1,1,1,195,450,2274,"0.0.0.0",0,5094107020789902,false,1687124141,794954,794954,"[{""sequence"":4294967293,""witness"":""02483045022100f2d00f7176019c2a2c0806e1131e467f0ff882003df2e66aec812b7e7b5923ea0220368b8f625b5abac31b8367a74d510035091ac61d4f9616be46746838d6813ce80121031f486264a9ba4bd0473bd31adf6944b4bd679684b32606d76fa1a3a567450c8c"",""script"":"""",""index"":0,""prev_out"":{""addr"":""bc1qnu45hcg9s8c8aug4uwymf8485x8hh2pvw55unw"",""n"":49,""script"":""00149f2b4be10581f07ef115e389b49ea7a18f7ba82c"",""spending_outpoints"":[{""n"":0,""tx_index"":5094107020789902}],""spent"":true,""tx_index"":2365357800623910,""type"":0,""value"":28173}}]","[{""type"":0,""spent"":false,""value"":25899,""spending_outpoints"":[],""n"":0,""tx_index"":5094107020789902,""script"":""76a914a0b0d60e5991578ed37cbda2b17d8b2ce23ab29588ac"",""addr"":""1FeexV6bAHb8ybZjqQMjJrcCrHGW9sb6uF""}]",25899,7995725392336
"2de016d235b371c434fd56f01d3c84a45cd93c9874ef2a6c316fe84f28c5402b",1,1,21,852,3078,121020,"0.0.0.0",0,1521829940952333,false,1685720076,792567,792567,"[{""sequence"":4294967295,""witness"":""02483045022100d96674784c747cbcae34c55c5a0817e661452cfaf9d2890ef1551d5c535e5e880220538a78feb040e6455036ff359d02f6f10da0c5eb3df1ef84b019b81f9e411ef80121022a51bd8200f44d72e94fa623ad6f79efb10fa6a873b5a8cf1c63b47f6301729b"",""script"":"""",""index"":0,""prev_out"":{""addr"":""bc1qprdf80adfz7aekh5nejjfrp3jksc8r929svpxk"",""n"":20,""script"":""001408da93bfad48bddcdaf49e65248c3195a1838caa"",""spending_outpoints"":[{""n"":0,""tx_index"":1521829940952333}],""spent"":true,""tx_index"":6129255575274530,""type"":0,""value"":11363363797}}]","[{""type"":0,""spent"":true,""value"":556052,""spending_outpoints"":[{""tx_index"":6125045785043049,""n"":1}],""n"":0,""tx_index"":1521829940952333,""script"":""00140a83ebbda76b16a7173cad6d55f38b990c772162"",""addr"":""bc1qp2p7h0d8dvt2w9eu44k4tuutnyx8wgtz0d4e45""},{""type"":0,""spent"":true,""value"":1297408,""spending_outpoints"":[{""tx_index"":7574927174447562,""n"":38}],""n"":1,""tx_index"":1521829940952333,""script"":""76a914125b0050d4331d042fc9706da87b1fc07dbed8cf88ac"",""addr"":""12g4BL7Q7fFmd8t9UKG86aRBUk8ue2BGKx""},{""type"":0,""spent"":true,""value"":77864,""spending_outpoints"":[{""tx_index"":3656256864156453,""n"":0}],""n"":2,""tx_index"":1521829940952333,""script"":""0014ba2cf0ee889a024784f0b20ee49d8f08b8a22d60"",""addr"":""bc1qhgk0pm5gngpy0p8skg8wf8v0pzu2yttq6zvrpv""},{""type"":0,""spent"":true,""value"":750000,""spending_outpoints"":[{""tx_index"":2966004115074150,""n"":15}],""n"":3,""tx_index"":1521829940952333,""script"":""76a914fcf7810d14862b32db3584b7af515a9afca29f3f88ac"",""addr"":""1Q4ZnEE4dxzYuDPBQwyv7h7cJPoBaLZYuD""},{""type"":0,""spent"":true,""value"":1798223,""spending_outpoints"":[{""tx_index"":6052800401978655,""n"":58}],""n"":4,""tx_index"":1521829940952333,""script"":""76a914d2755e528661be88ccbdab104b819e177470d40588ac"",""addr"":""1LBoWBrBBvtLygCoJGMrH3Yqu3LDBkRBM9""},{""type"":0,""spent"":true,""value"":1000000,""spending_outpoints"":[{""tx_index"":5031055825300184,""n"":7}],""n"":5,""tx_index"":1521829940952333,""script"":""76a914148e14f8043d841b5fbaa191481f95686c805faf88ac"",""addr"":""12sgirvYUf1fdoabKMYuh26zdTFQrjdceB""},{""type"":0,""spent"":true,""value"":179191,""spending_outpoints"":[{""tx_index"":2149289380751192,""n"":156}],""n"":6,""tx_index"":1521829940952333,""script"":""a914737f8fc64f48438cbe79ebb4886aeaed54b3ac6887"",""addr"":""3CDiSjvt27sANufQSn6KPb9a4rw34wLz3a""},{""type"":0,""spent"":true,""value"":1360917,""spending_outpoints"":[{""tx_index"":7960423989073987,""n"":61}],""n"":7,""tx_index"":1521829940952333,""script"":""a9145e00ddf9d83afea8a0005887b77d0becfaf36c9887"",""addr"":""3AG4UpfFMmYZZNpSTE2c9meFMx9rjYtFcd""},{""type"":0,""spent"":true,""value"":927488,""spending_outpoints"":[{""tx_index"":5265435756476374,""n"":93}],""n"":8,""tx_index"":1521829940952333,""script"":""0014954903139eca984785eae08d1995c23df3c718f0"",""addr"":""bc1qj4ysxyu7e2vy0p02uzx3n9wz8heuwx8sr9z9af""},{""type"":0,""spent"":true,""value"":37071,""spending_outpoints"":[{""tx_index"":5412590545224088,""n"":33}],""n"":9,""tx_index"":1521829940952333,""script"":""a9148ad21d547717557dee081d60ada9b90535f93ec587"",""addr"":""3EM2t2qz59122s34q5q98ukQ3BKDpQNnmG""},{""type"":0,""spent"":true,""value"":385610,""spending_outpoints"":[{""tx_index"":2553502041879688,""n"":11}],""n"":10,""tx_index"":1521829940952333,""script"":""76a9144ee86d33199f0cd4720740bf23789715151fd0ea88ac"",""addr"":""18CE9F7ca5JTbku9Y4ATi74TC1WcrBkVP6""},{""type"":0,""spent"":true,""value"":945704,""spending_outpoints"":[{""tx_index"":6853794447633889,""n"":19}],""n"":11,""tx_index"":1521829940952333,""script"":""76a91474a048bad31de24707c4a246b96697db041933c888ac"",""addr"":""1BdfPzEtRumde1C2ApNDWBpag5HiB6NTKw""},{""type"":0,""spent"":true,""value"":190107,""spending_outpoints"":[{""tx_index"":8153029038406120,""n"":0}],""n"":12,""tx_index"":1521829940952333,""script"":""00149d1c49c76ed5c5c1f07b61a3f66c1e6ab1a01dfc"",""addr"":""bc1qn5wyn3mw6hzururmvx3lvmq7d2c6q80umqqq9l""},{""type"":0,""spent"":true,""value"":1113300,""spending_outpoints"":[{""tx_index"":2332742569269829,""n"":0}],""n"":13,""tx_index"":1521829940952333,""script"":""0014bacd770ad7f6765cdf4aa206a63b58a9690eda1b"",""addr"":""bc1qhtxhwzkh7em9eh625gr2vw6c495saksmnuw0d0""},{""type"":0,""spent"":true,""value"":378314,""spending_outpoints"":[{""tx_index"":564983200406140,""n"":127}],""n"":14,""tx_index"":1521829940952333,""script"":""a9148d568766203ba4817e0ec8b407e6b6c98a92eb8687"",""addr"":""3EaLrj2Mno6j9ZKWuEyTErBGoMT7JaTAeb""},{""type"":0,""spent"":true,""value"":556189,""spending_outpoints"":[{""tx_index"":3925844129760436,""n"":3}],""n"":15,""tx_index"":1521829940952333,""script"":""76a9145d3af8f41d4396710af9629853b1fbed2fe1803488ac"",""addr"":""19VxVKYCJ8XphBxvegywbQRmsu6Sq5mhEo""},{""type"":0,""spent"":false,""value"":25899,""spending_outpoints"":[],""n"":16,""tx_index"":1521829940952333,""script"":""76a914a0b0d60e5991578ed37cbda2b17d8b2ce23ab29588ac"",""addr"":""1FeexV6bAHb8ybZjqQMjJrcCrHGW9sb6uF""},{""type"":0,""spent"":true,""value"":5399585,""spending_outpoints"":[{""tx_index"":832625272516851,""n"":0}],""n"":17,""tx_index"":1521829940952333,""script"":""001469f32d4866073a3c41224081328f7927f0195c04"",""addr"":""bc1qd8ej6jrxquarcsfzgzqn9rmeylcpjhqyasvfn2""},{""type"":0,""spent"":true,""value"":383000,""spending_outpoints"":[{""tx_index"":8224236745710360,""n"":0}],""n"":18,""tx_index"":1521829940952333,""script"":""00143da276609687e62fa3abb3d9e70b59c0b24cd0f7"",""addr"":""bc1q8k38vcykslnzlgatk0v7wz6eczeye58h744xec""},{""type"":0,""spent"":true,""value"":726715,""spending_outpoints"":[{""tx_index"":7794027911703294,""n"":108}],""n"":19,""tx_index"":1521829940952333,""script"":""00202f8d73d5fff737147bee10417f02971a269bbe228e5157d1f2af22cba17e1c9f"",""addr"":""bc1q97xh840l7um3g7lwzpqh7q5hrgnfh03z3eg4050j4u3vhgt7rj0ss3ql48""},{""type"":0,""spent"":true,""value"":11345154140,""spending_outpoints"":[{""tx_index"":7267621555785039,""n"":0}],""n"":20,""tx_index"":1521829940952333,""script"":""001408da93bfad48bddcdaf49e65248c3195a1838caa"",""addr"":""bc1qprdf80adfz7aekh5nejjfrp3jksc8r929svpxk""}]",25899,7995725366437
"2fad9ed5f203ff0a06cc52e42eeacdff4ade0f50fc7433a7c25c5baf86045700",1,1,20,813,2925,115066,"0.0.0.0",0,11959618890603,false,1685720075,792567,792567,"[{""sequence"":4294967295,""witness"":""0247304402202950de57aaa5d03d7a0b8655795c302d31f0535cb5d124cb01dd9b3b9fde501d02205b13bd9e1b39592bd01f2dd64f69f3cfe64c79ba381a8157b7ec6189846f3b4d0121022a51bd8200f44d72e94fa623ad6f79efb10fa6a873b5a8cf1c63b47f6301729b"",""script"":"""",""index"":0,""prev_out"":{""addr"":""bc1qprdf80adfz7aekh5nejjfrp3jksc8r929svpxk"",""n"":19,""script"":""001408da93bfad48bddcdaf49e65248c3195a1838caa"",""spending_outpoints"":[{""n"":0,""tx_index"":11959618890603}],""spent"":true,""tx_index"":6437945959829228,""type"":0,""value"":2671416418}}]","[{""type"":0,""spent"":true,""value"":593565,""spending_outpoints"":[{""tx_index"":8403462939012768,""n"":16}],""n"":0,""tx_index"":11959618890603,""script"":""a91415de403739981ac8c0d5f2cf87fab5adea041cfc87"",""addr"":""33geMqBHtE9psA2cQxMPmi5Y63XML2aLFu""},{""type"":0,""spent"":true,""value"":271310,""spending_outpoints"":[{""tx_index"":2653290707108267,""n"":10}],""n"":1,""tx_index"":11959618890603,""script"":""a914f0f4fb49e04fd40cd7213a1d7ec446072f41d70887"",""addr"":""3Pf5aCiKUzwA6Nk1H8wUM73KXU3xNo8EyF""},{""type"":0,""spent"":true,""value"":6349000,""spending_outpoints"":[{""tx_index"":2375286802028357,""n"":0}],""n"":2,""tx_index"":11959618890603,""script"":""0020b30ca42f40cb5de8f1e2dff817665b405414f8558d71bff2184f5fcd2b643ba9"",""addr"":""bc1qkvx2gt6qedw73u0zmlupwejmgp2pf7z434cmluscfa0u62my8w5sktr08q""},{""type"":0,""spent"":true,""value"":732192,""spending_outpoints"":[{""tx_index"":4847754048853303,""n"":4}],""n"":3,""tx_index"":11959618890603,""script"":""76a91475aee97a612c570d65e048259d9d7f186512218f88ac"",""addr"":""1BjFbYb6WAfnus5CbDVeSjFWV5eXYb46wj""},{""type"":0,""spent"":true,""value"":732614,""spending_outpoints"":[{""tx_index"":430711537659178,""n"":0}],""n"":4,""tx_index"":11959618890603,""script"":""a9140a1ad16442fc56de50d782c161918194d1dec7a387"",""addr"":""32cSooe2SeozM1DRXyvfBxVJC9Zim1wZbk""},{""type"":0,""spent"":false,""value"":13200000,""spending_outpoints"":[],""n"":5,""tx_index"":11959618890603,""script"":""0014e829cd7b5dee5579213f9b084d0ffdccf430c63f"",""addr"":""bc1qaq5u676aae2hjgflnvyy6rlaen6rp33lyzynca""},{""type"":0,""spent"":true,""value"":1112395,""spending_outpoints"":[{""tx_index"":3608861578566974,""n"":0}],""n"":6,""tx_index"":11959618890603,""script"":""00149d00ca161c8d810e9eac0014dfad3e1006e8c31f"",""addr"":""bc1qn5qv59su3kqsa84vqq2dltf7zqrw3sclrcmutv""},{""type"":0,""spent"":true,""value"":5265958,""spending_outpoints"":[{""tx_index"":2867647103994723,""n"":36}],""n"":7,""tx_index"":11959618890603,""script"":""76a914016a484ec5a10bc9e22624a5668891b78c87828688ac"",""addr"":""18Uzpur775QrYXgq7Dn61LpifA1MEf1ti""},{""type"":0,""spent"":true,""value"":240181,""spending_outpoints"":[{""tx_index"":3174558939741655,""n"":74}],""n"":8,""tx_index"":11959618890603,""script"":""a914577cde733734cf60d4bdf742d383a85a7067e8ff87"",""addr"":""39fcJHAHU8gRqKNz2DgY7FptPgBuQKgrgp""},{""type"":0,""spent"":false,""value"":2326,""spending_outpoints"":[],""n"":9,""tx_index"":11959618890603,""script"":""76a914a0b0d60e5991578ed37cbda2b17d8b2ce23ab29588ac"",""addr"":""1FeexV6bAHb8ybZjqQMjJrcCrHGW9sb6uF""},{""type"":0,""spent"":true,""value"":714618,""spending_outpoints"":[{""tx_index"":8216287933393086,""n"":1}],""n"":10,""tx_index"":11959618890603,""script"":""a914403703256f8b50640c0730ab7f30d4452c4c75cd87"",""addr"":""37YZ59BL1zJmwMn5hJJ2dXEb2P5pidVnCB""},{""type"":0,""spent"":true,""value"":556686,""spending_outpoints"":[{""tx_index"":8309496505040109,""n"":286}],""n"":11,""tx_index"":11959618890603,""script"":""a9144ce6142b0e21e8135f89e3cf6287200f29a9fe0087"",""addr"":""38hcuH1ipnpAqwRc6aZ4J3CijqaSxs3VhQ""},{""type"":0,""spent"":true,""value"":3124617,""spending_outpoints"":[{""tx_index"":5767420600103199,""n"":67}],""n"":12,""tx_index"":11959618890603,""script"":""00148dccfa1e60c8a9689b10d9a662a230bc3288aea8"",""addr"":""bc1q3hx058nqez5k3xcsmxnx9g3shseg3t4g232qjr""},{""type"":0,""spent"":true,""value"":74781,""spending_outpoints"":[{""tx_index"":5792994993604972,""n"":167}],""n"":13,""tx_index"":11959618890603,""script"":""001450b3bf8c56bd19c901cd34a4127192761272eff9"",""addr"":""bc1q2zemlrzkh5vujqwdxjjpyuvjwcf89mleac8elh""},{""type"":0,""spent"":true,""value"":519537,""spending_outpoints"":[{""tx_index"":2802210649540189,""n"":437}],""n"":14,""tx_index"":11959618890603,""script"":""a914ee8c1e92b36af5c22659098fa832b707faf974a787"",""addr"":""3PSLbsHVa9YJyZpeznbP19Fw3pN8CJRhPm""},{""type"":0,""spent"":true,""value"":55588,""spending_outpoints"":[{""tx_index"":5059606747675163,""n"":166}],""n"":15,""tx_index"":11959618890603,""script"":""a914056f9f8abe13e440e66dc0339230f832c4d8fca387"",""addr"":""32Bm2DgrBEA6sZiUtwSXafDg8jnM9CPxzn""},{""type"":0,""spent"":true,""value"":181739,""spending_outpoints"":[{""tx_index"":1320347246820017,""n"":154}],""n"":16,""tx_index"":11959618890603,""script"":""00148569fbd62b6ba9768a9ae998818d114f81f4764e"",""addr"":""bc1qs45lh43tdw5hdz56axvgrrg3f7qlgajwva659q""},{""type"":0,""spent"":true,""value"":72296,""spending_outpoints"":[{""tx_index"":4593823509640556,""n"":499}],""n"":17,""tx_index"":11959618890603,""script"":""76a9143520606ec7a4744884e1d53e35b23ee2ab3a782f88ac"",""addr"":""15qubjrean1roDxKKfR2p9mhPNSNvCQutu""},{""type"":0,""spent"":true,""value"":155766,""spending_outpoints"":[{""tx_index"":2443921892615296,""n"":41}],""n"":18,""tx_index"":11959618890603,""script"":""a914cf0bcc86c0a92b83d65f5aa4868f7eaf1d9550d987"",""addr"":""3LZmw4FCC88BHDiXNQ1fiHptug9u9HWtJU""},{""type"":0,""spent"":true,""value"":2637346183,""spending_outpoints"":[{""tx_index"":6313882727135666,""n"":0}],""n"":19,""tx_index"":11959618890603,""script"":""001408da93bfad48bddcdaf49e65248c3195a1838caa"",""addr"":""bc1qprdf80adfz7aekh5nejjfrp3jksc8r929svpxk""}]",2326,7995725340538
"53f6344ac75d95964243bdafc8ff54fb3b5d90233e995e38e4ea3b16d5153e4e",1,1,21,834,3006,145885,"0.0.0.0",0,2752913959208829,false,1685286734,791806,791806,"[{""sequence"":4294967295,""witness"":""024830450221009a905d9d1fd7cca928a076da3b0952f791ffcb0b187b53f763dc8f0a839266f40220720f2d11baee06b5353fa0d755605303c2555abf70b2f95b9d4c596ac6d2d2840121022a51bd8200f44d72e94fa623ad6f79efb10fa6a873b5a8cf1c63b47f6301729b"",""script"":"""",""index"":0,""prev_out"":{""addr"":""bc1qprdf80adfz7aekh5nejjfrp3jksc8r929svpxk"",""n"":20,""script"":""001408da93bfad48bddcdaf49e65248c3195a1838caa"",""spending_outpoints"":[{""n"":0,""tx_index"":2752913959208829}],""spent"":true,""tx_index"":1645159229026673,""type"":0,""value"":422563324}}]","[{""type"":0,""spent"":true,""value"":643472,""spending_outpoints"":[{""tx_index"":1981408181085649,""n"":0}],""n"":0,""tx_index"":2752913959208829,""script"":""a9140f7d6c1bba62191d81e72ce2d30a2e276edd7cb887"",""addr"":""336vJv3BKXj6mLaUyhF86mr91wBVwB2JZ8""},{""type"":0,""spent"":false,""value"":25899,""spending_outpoints"":[],""n"":1,""tx_index"":2752913959208829,""script"":""76a914a0b0d60e5991578ed37cbda2b17d8b2ce23ab29588ac"",""addr"":""1FeexV6bAHb8ybZjqQMjJrcCrHGW9sb6uF""},{""type"":0,""spent"":true,""value"":164555,""spending_outpoints"":[{""tx_index"":4037826197463682,""n"":384}],""n"":2,""tx_index"":2752913959208829,""script"":""a914c77d1f2e025b309d6fb6957b9b64b40850f345d587"",""addr"":""3KspHLFkg9WzsycNV5y7EBUXtaBueSCEwr""},{""type"":0,""spent"":false,""value"":1838821,""spending_outpoints"":[],""n"":3,""tx_index"":2752913959208829,""script"":""0014d0f96753a660e5ea5c80093ef9af3c4fd27f6c55"",""addr"":""bc1q6rukw5axvrj75hyqpyl0nteuflf87mz4cnh64s""},{""type"":0,""spent"":true,""value"":238812,""spending_outpoints"":[{""tx_index"":7951575468616655,""n"":379}],""n"":4,""tx_index"":2752913959208829,""script"":""a914c6ee0421e68b4c86ae1fb5b649a7df3dcee0b7a987"",""addr"":""3KprrBFveQ7to5wLEgdaACVZDMdSGHjQX7""},{""type"":0,""spent"":true,""value"":609178,""spending_outpoints"":[{""tx_index"":2112636547692079,""n"":110}],""n"":5,""tx_index"":2752913959208829,""script"":""a914d76193c90f327cc5302e1bfb18b74c5b47a11d0687"",""addr"":""3MKr6aN1y2Ny7GeF6T2CqJfa8JEk3NTGUL""},{""type"":0,""spent"":true,""value"":95520,""spending_outpoints"":[{""tx_index"":2854146869308235,""n"":177}],""n"":6,""tx_index"":2752913959208829,""script"":""0014baf357dc555a236e9343c61e97b7a5e10b7e7dd8"",""addr"":""bc1qhte40hz4tg3kay6rcc0f0da9uy9hulwcfwnzel""},{""type"":0,""spent"":true,""value"":7349675,""spending_outpoints"":[{""tx_index"":8363977198339465,""n"":101}],""n"":7,""tx_index"":2752913959208829,""script"":""0014398e550a1d929d5124713d7b55ffd5f640448c82"",""addr"":""bc1q8x892zsaj2w4zfr384a4tl747eqyfryzfpklqn""},{""type"":0,""spent"":true,""value"":250000,""spending_outpoints"":[{""tx_index"":5162293340899198,""n"":2}],""n"":8,""tx_index"":2752913959208829,""script"":""76a9149d891bf571ed3f9ae2349ba35bcf1f9a61cd7ad688ac"",""addr"":""1FMyLdgyLVsJoDEk4CqvUSEdZjuygLpbzT""},{""type"":0,""spent"":true,""value"":3644017,""spending_outpoints"":[{""tx_index"":5432909027007958,""n"":58}],""n"":9,""tx_index"":2752913959208829,""script"":""76a914c1dcbbc4d89ec8642c2f9642fd89cb19c867020888ac"",""addr"":""1Jg3qrXCbG839YZxWPmtK3zrSMG6QYqFHy""},{""type"":0,""spent"":true,""value"":395661,""spending_outpoints"":[{""tx_index"":8153603008698026,""n"":970}],""n"":10,""tx_index"":2752913959208829,""script"":""a914221204df32019d26ea9b608ea6bb52210ba7a48187"",""addr"":""34oAV3s6B9T8eGweykupWz5akGfvgBtY7i""},{""type"":0,""spent"":true,""value"":700000,""spending_outpoints"":[{""tx_index"":6631294243326731,""n"":0}],""n"":11,""tx_index"":2752913959208829,""script"":""a91491662489a795bf2ddc83833a8383da56ff2d3b5a87"",""addr"":""3EwpGMqnhdrUaeqbAhc3XicEMvkt5uwoaH""},{""type"":0,""spent"":false,""value"":1281600,""spending_outpoints"":[],""n"":12,""tx_index"":2752913959208829,""script"":""001407635f40a14bcd09a5adcd8f6854457d560d64d3"",""addr"":""bc1qqa347s9pf0xsnfddek8ks4z904tq6exnacyfs7""},{""type"":0,""spent"":true,""value"":1300000,""spending_outpoints"":[{""tx_index"":2104145840077248,""n"":48}],""n"":13,""tx_index"":2752913959208829,""script"":""76a9147816dd51844c9b85d2c884b6f82b6f5856a2a7b988ac"",""addr"":""1BwyUg8i4tpAKyXG6FnKnXvUEesZWJm5yC""},{""type"":0,""spent"":true,""value"":16537180,""spending_outpoints"":[{""tx_index"":4432649504021520,""n"":57}],""n"":14,""tx_index"":2752913959208829,""script"":""a914e1198d7d0e38a473eddaad7811b9314d1aa096d687"",""addr"":""3NDEa8w6QgqU1ZMiDPpuicotvVwkfzhYRg""},{""type"":0,""spent"":true,""value"":11726864,""spending_outpoints"":[{""tx_index"":3098279016824933,""n"":74}],""n"":15,""tx_index"":2752913959208829,""script"":""76a914a619a32c8e4ac7a963d3c7f9ef27bf19991e2dec88ac"",""addr"":""1G9FtANQGWsa1i49Gv8beCjVKHjkBVHprU""},{""type"":0,""spent"":false,""value"":2700000,""spending_outpoints"":[],""n"":16,""tx_index"":2752913959208829,""script"":""001419a93f28c8eb881bffbb43d5349076bc90bd6bee"",""addr"":""bc1qrx5n72xgawyphlamg02nfyrkhjgt66lw7y28q8""},{""type"":0,""spent"":true,""value"":928922,""spending_outpoints"":[{""tx_index"":4002281148152565,""n"":2}],""n"":17,""tx_index"":2752913959208829,""script"":""00141ba2acb23147428dd61f42e1faa5937d3089699e"",""addr"":""bc1qrw32ev33gapgm4slgtsl4fvn05cgj6v73n82gv""},{""type"":0,""spent"":true,""value"":18000000,""spending_outpoints"":[{""tx_index"":4923113542172800,""n"":0}],""n"":18,""tx_index"":2752913959208829,""script"":""0014d3a28d1efe02f99684b2b4eccdef9948b4ed0a8a"",""addr"":""bc1q6w3g68h7qtuedp9jknkvmmuefz6w6z52n02mtl""},{""type"":0,""spent"":true,""value"":1176247,""spending_outpoints"":[{""tx_index"":3018562452678493,""n"":0}],""n"":19,""tx_index"":2752913959208829,""script"":""0014460e2788b131d28dab299aecf38d49271eb92f00"",""addr"":""bc1qgc8z0z93x8fgm2efntk08r2fyu0tjtcqjznh72""},{""type"":0,""spent"":true,""value"":352811016,""spending_outpoints"":[{""tx_index"":5149064901831193,""n"":0}],""n"":20,""tx_index"":2752913959208829,""script"":""001408da93bfad48bddcdaf49e65248c3195a1838caa"",""addr"":""bc1qprdf80adfz7aekh5nejjfrp3jksc8r929svpxk""}]",25899,7995725338212
"ccddb29ce96fa92f31c80fcf9588929adcff7fbbe03a9d327f82242a04ae1ea1",2,1,2,505,853,11770,"0.0.0.0",0,5668900499178640,false,1685051348,791393,791393,"[{""sequence"":4294967293,""witness"":""0340f6b17ed7af4040416817496ab22e75f8a61216804b73f44b40bf946edad31a923273e052bc6ba98e36fea14488b4f352cb0a264c612c1b1faf5de11c9463e953fd1c0120117f692257b2331233b5705ce9c682be8719ff1b2b64cbca290bd6faeb54423eac06ce9ae2548801750063036f7264010118746578742f706c61696e3b636861727365743d7574662d38004ccd7b2270223a224f74686572732d3230222c226f70223a226465706c6f792d4150222c227469636b223a226f74425443222c22737263223a2231466565785636624148623879625a6a71514d6a4a72634372484757397362367546222c22746172223a226263317064776a63796b356e6d66337871716b636537787239616a30306c37307566776b6a387a6d30366a6e776a64717a7a6430716b6671667132647575222c2262616c223a223739393537222c22636f6e74656e74223a227468654f74686572732e696f2f4150227d6821c0117f692257b2331233b5705ce9c682be8719ff1b2b64cbca290bd6faeb54423e"",""script"":"""",""index"":0,""prev_out"":{""addr"":""bc1pqf03af0karpzc62r6numr3cf9tqlahngrdaga7qutc2slvnm7gxq25nkta"",""n"":0,""script"":""5120025f1ea5f6e8c22c6943d4f9b1c7092ac1fede681b7a8ef81c5e150fb27bf20c"",""spending_outpoints"":[{""n"":0,""tx_index"":5668900499178640}],""spent"":true,""tx_index"":4356577693496691,""type"":0,""value"":15000}}]","[{""type"":0,""spent"":false,""value"":546,""spending_outpoints"":[],""n"":0,""tx_index"":5668900499178640,""script"":""76a914a0b0d60e5991578ed37cbda2b17d8b2ce23ab29588ac"",""addr"":""1FeexV6bAHb8ybZjqQMjJrcCrHGW9sb6uF""},{""type"":0,""spent"":true,""value"":2684,""spending_outpoints"":[{""tx_index"":4152313524824417,""n"":57}],""n"":1,""tx_index"":5668900499178640,""script"":""0014408cdf1a6ca3b3f50c34481e6f40e8af66d070f3"",""addr"":""bc1qgzxd7xnv5wel2rp5fq0x7s8g4andqu8n08dsp7""}]",546,7995725312313
"135d7e5938117390565b126f6a690ac6a34be530df2061554adec19ade5caaf9",1,1,2,226,574,8928,"0.0.0.0",0,8784323131168827,false,1685038620,791370,791370,"[{""sequence"":4294967293,""witness"":""02483045022100cf7f5d829667849392b06025b4ff9cdcdef2e74e79fd64483f3418d1b8a392260220616f8b7a27ad2f3d57c91f96883d578fc32d9a9a0ab9b3080cd6896c598122b1012102bc1e18d55cb3dd5f19b4e8a8d78f3ca08dd65e05dfd3096f57d3ab48651a0ee7"",""script"":"""",""index"":0,""prev_out"":{""addr"":""bc1qnsgq5vstelvtu39d9tjpfs8ejd3kye3m7rawmn"",""n"":1,""script"":""00149c100a320bcfd8be44ad2ae414c0f9936362663b"",""spending_outpoints"":[{""n"":0,""tx_index"":8784323131168827}],""spent"":true,""tx_index"":3756245885122585,""type"":0,""value"":1470125}}]","[{""type"":0,""spent"":false,""value"":666,""spending_outpoints"":[],""n"":0,""tx_index"":8784323131168827,""script"":""76a914a0b0d60e5991578ed37cbda2b17d8b2ce23ab29588ac"",""addr"":""1FeexV6bAHb8ybZjqQMjJrcCrHGW9sb6uF""},{""type"":0,""spent"":true,""value"":1460531,""spending_outpoints"":[{""tx_index"":166515265940364,""n"":0}],""n"":1,""tx_index"":8784323131168827,""script"":""001481ab319fd3b2a75a8941052fdd05d769975cdcf0"",""addr"":""bc1qsx4nr87nk2n44z2pq5ha6pwhdxt4eh8scnpgd8""}]",666,7995725311767
"323894cff8c540df4f566a820790c307e422ae989614c21e08ede92b5336edbd",1,1,21,844,3046,441666,"0.0.0.0",0,6682448522214717,false,1683923997,789437,789437,"[{""sequence"":4294967295,""witness"":""02483045022100e49709fb6fe6575711548f88a271bbcede6464580e7ea9356fc97eecf7d67fee022059ef4145560a0d5dcc73b88fd2cccbe5de6e89c2c14baff7863c58afe4631f530121022a51bd8200f44d72e94fa623ad6f79efb10fa6a873b5a8cf1c63b47f6301729b"",""script"":"""",""index"":0,""prev_out"":{""addr"":""bc1qprdf80adfz7aekh5nejjfrp3jksc8r929svpxk"",""n"":20,""script"":""001408da93bfad48bddcdaf49e65248c3195a1838caa"",""spending_outpoints"":[{""n"":0,""tx_index"":6682448522214717}],""spent"":true,""tx_index"":7742829903766903,""type"":0,""value"":15398720154}}]","[{""type"":0,""spent"":true,""value"":56772,""spending_outpoints"":[{""tx_index"":587991120167310,""n"":23}],""n"":0,""tx_index"":6682448522214717,""script"":""76a914e389a5f261f4c60223d66736f6cd07eb2c2d741e88ac"",""addr"":""1Mk7HWhxCK5reHeuAq6vizz8Q3mn6e3aPw""},{""type"":0,""spent"":true,""value"":1185638,""spending_outpoints"":[{""tx_index"":7244931189766064,""n"":89}],""n"":1,""tx_index"":6682448522214717,""script"":""76a914d72ffe9db011ec474534f8dd07302736360ae84488ac"",""addr"":""1Lcomy3rmoQ6JCD3okpML2oTW7t7ume3iB""},{""type"":0,""spent"":true,""value"":540730,""spending_outpoints"":[{""tx_index"":373888223403843,""n"":3}],""n"":2,""tx_index"":6682448522214717,""script"":""76a914b97ee0649b3d4e7cc997388a031efb16d3615e7e88ac"",""addr"":""1Hup12SYftncvN1jJidd75W4eNdhshF3Ze""},{""type"":0,""spent"":true,""value"":762892,""spending_outpoints"":[{""tx_index"":3813919351952563,""n"":399}],""n"":3,""tx_index"":6682448522214717,""script"":""001489c09a0d6930bab2cdc07691b724f8184ec67852"",""addr"":""bc1q38qf5rtfxzat9nwqw6gmwf8crp8vv7zjnal0sa""},{""type"":0,""spent"":true,""value"":1813592,""spending_outpoints"":[{""tx_index"":2662422893401654,""n"":0}],""n"":4,""tx_index"":6682448522214717,""script"":""76a914c7e599c4abad88d2601a9de9917d608760295c4988ac"",""addr"":""1KDxX7Ew57dwJZ8WrYQqKcENseBQHqJ3a6""},{""type"":0,""spent"":true,""value"":831417,""spending_outpoints"":[{""tx_index"":5004480013947608,""n"":0}],""n"":5,""tx_index"":6682448522214717,""script"":""a914cf542e76e7e6d367361b693aa856964e455bc91387"",""addr"":""3LbGeHYA3Xg4r41xKJLSz79Wy1GwZWUzyL""},{""type"":0,""spent"":false,""value"":566292,""spending_outpoints"":[],""n"":6,""tx_index"":6682448522214717,""script"":""76a914633597dcc6f7b00ea60e4fb68a91ec720441bb9f88ac"",""addr"":""1A3a6iMCPuSUgju5WkvgozEcADq8EKJefe""},{""type"":0,""spent"":true,""value"":690938,""spending_outpoints"":[{""tx_index"":6205086784276212,""n"":20}],""n"":7,""tx_index"":6682448522214717,""script"":""00148c630b37f149e5307f66bef0915f60736a84edce"",""addr"":""bc1q333skdl3f8jnqlmxhmcfzhmqwd4gfmwwg7e6dj""},{""type"":0,""spent"":true,""value"":413372,""spending_outpoints"":[{""tx_index"":520052370798066,""n"":0}],""n"":8,""tx_index"":6682448522214717,""script"":""0014a4ea1b0ef2f7da85e82ae2a1d5e32fd8ddbb5883"",""addr"":""bc1q5n4pkrhj7ldgt6p2u2satce0mrwmkkyrx0j5nd""},{""type"":0,""spent"":true,""value"":2449386,""spending_outpoints"":[{""tx_index"":1742211777734679,""n"":2}],""n"":9,""tx_index"":6682448522214717,""script"":""76a914e212b242a3da88f68a850501c5e33af7b84e713d88ac"",""addr"":""1McN7Q3tmnTN36n7AAP7ZCADCT7kCTinqk""},{""type"":0,""spent"":true,""value"":7576161,""spending_outpoints"":[{""tx_index"":2954373737256560,""n"":2}],""n"":10,""tx_index"":6682448522214717,""script"":""a914e95b1516f08c22b624f425da803ba60c03f896e787"",""addr"":""3NxtUkkCtTK5LJJG1BbtEnJVZJtacwBR6R""},{""type"":0,""spent"":true,""value"":1101685,""spending_outpoints"":[{""tx_index"":7948109325653223,""n"":18}],""n"":11,""tx_index"":6682448522214717,""script"":""76a914e21790d599fa3bbbafd29dd30ae1a640e7e9a23e88ac"",""addr"":""1McTwjRDTcLozeGpy2CGBbJ5TFeARQ7Rfe""},{""type"":0,""spent"":true,""value"":1515462,""spending_outpoints"":[{""tx_index"":4390374815942655,""n"":32}],""n"":12,""tx_index"":6682448522214717,""script"":""a914860f33e3ae9234850a1a3b35249a6aa500a9608887"",""addr"":""3DurgYteGaxqNi4hbYFTEgv6X2yBZ2AocW""},{""type"":0,""spent"":true,""value"":151541,""spending_outpoints"":[{""tx_index"":4575410380159648,""n"":0}],""n"":13,""tx_index"":6682448522214717,""script"":""76a9148bcea3ee60b956caede008ae53aa2cbe0c3deb0788ac"",""addr"":""1DkEUHi6DkpsF7F3SzKVAG2YVCnqKzwWe2""},{""type"":0,""spent"":false,""value"":25899,""spending_outpoints"":[],""n"":14,""tx_index"":6682448522214717,""script"":""76a914a0b0d60e5991578ed37cbda2b17d8b2ce23ab29588ac"",""addr"":""1FeexV6bAHb8ybZjqQMjJrcCrHGW9sb6uF""},{""type"":0,""spent"":true,""value"":1861660,""spending_outpoints"":[{""tx_index"":2334577351971521,""n"":1}],""n"":15,""tx_index"":6682448522214717,""script"":""00146536f61aaca1e74d90cb3fc0fb3fcf151eb266ef"",""addr"":""bc1qv5m0vx4v58n5myxt8lq0k070z50tyeh0zh8z5a""},{""type"":0,""spent"":true,""value"":109376,""spending_outpoints"":[{""tx_index"":4908473322321744,""n"":1}],""n"":16,""tx_index"":6682448522214717,""script"":""a9141342f5929526f332c42f0c2d5ed11a70c7af9b1287"",""addr"":""33SrybkkaqQALckfCe2tYieWE8sY17ZD3o""},{""type"":0,""spent"":true,""value"":97578,""spending_outpoints"":[{""tx_index"":6485362873583989,""n"":0}],""n"":17,""tx_index"":6682448522214717,""script"":""0014ade49877f1c0100b600ee848a9379c3ee6722f02"",""addr"":""bc1q4hjfsal3cqgqkcqwapy2jduu8mn8ytczgcrzq3""},{""type"":0,""spent"":false,""value"":325964,""spending_outpoints"":[],""n"":18,""tx_index"":6682448522214717,""script"":""001496282193254e21323cbbb1280bfd9dd96efabb14"",""addr"":""bc1qjc5zrye9fcsny09mky5qhlvam9h04wc566sfqv""},{""type"":0,""spent"":true,""value"":223206,""spending_outpoints"":[{""tx_index"":2332689649287392,""n"":1}],""n"":19,""tx_index"":6682448522214717,""script"":""a91464f5b0dd85b77c57c868ab72b20283b2e8b9789487"",""addr"":""3AtqpdQGRWF165W15ftiPTJvVzRqv3LXTZ""},{""type"":0,""spent"":true,""value"":15375978927,""spending_outpoints"":[{""tx_index"":8349676242874447,""n"":0}],""n"":20,""tx_index"":6682448522214717,""script"":""001408da93bfad48bddcdaf49e65248c3195a1838caa"",""addr"":""bc1qprdf80adfz7aekh5nejjfrp3jksc8r929svpxk""}]",25899,7995725311101
"82008be1300bdc1e28a3f8a0524ad709765fbcbafc48580f7745606d000a5d31",1,1,20,801,2874,380000,"0.0.0.0",0,1736821424630792,false,1683590002,788847,788847,"[{""sequence"":4294967295,""witness"":""02483045022100b9bf8de6b042b1cc6d1df8b705971dfd41e42199e9052d54f2af7e7ec095109e02204626da037ef211b1c2d846de734c0805f4921e375935f6783b47a403a2c691390121022a51bd8200f44d72e94fa623ad6f79efb10fa6a873b5a8cf1c63b47f6301729b"",""script"":"""",""index"":0,""prev_out"":{""addr"":""bc1qprdf80adfz7aekh5nejjfrp3jksc8r929svpxk"",""n"":20,""script"":""001408da93bfad48bddcdaf49e65248c3195a1838caa"",""spending_outpoints"":[{""n"":0,""tx_index"":1736821424630792}],""spent"":true,""tx_index"":2207130640293538,""type"":0,""value"":446730398}}]","[{""type"":0,""spent"":true,""value"":630083,""spending_outpoints"":[{""tx_index"":5390417768896439,""n"":566}],""n"":0,""tx_index"":1736821424630792,""script"":""a914706efbecc4dd7c2b3b583916afa9a1aa61128f8787"",""addr"":""3BwWZLZ4zLVARUX7WAN4TSBvDuhKBgBssB""},{""type"":0,""spent"":true,""value"":418292,""spending_outpoints"":[{""tx_index"":2892938057274454,""n"":545}],""n"":1,""tx_index"":1736821424630792,""script"":""a914c58ec72000f7ff3c87274bec42cf5cd8ea5b6a2287"",""addr"":""3Khc5iFYQnLDTbHQNtGkdsQ8RXEfoE1V7R""},{""type"":0,""spent"":false,""value"":3682457,""spending_outpoints"":[],""n"":2,""tx_index"":1736821424630792,""script"":""00142e6783c7f207e5082f680cd6aeaeffa39385d199"",""addr"":""bc1q9enc83ljqljsstmgpnt2athl5wfct5veplgmpr""},{""type"":0,""spent"":true,""value"":273769,""spending_outpoints"":[{""tx_index"":1865706347872652,""n"":2}],""n"":3,""tx_index"":1736821424630792,""script"":""76a914c4e4d6b478942faf4c1f5028fbfa9168492036c388ac"",""addr"":""1Jx5abD1cEYXAvPSiDi46uBFYrNqkMNRcA""},{""type"":0,""spent"":true,""value"":380787,""spending_outpoints"":[{""tx_index"":7972554656155240,""n"":3}],""n"":4,""tx_index"":1736821424630792,""script"":""00143ec255a6f07d52614c7c0394dbea52f42afcaddd"",""addr"":""bc1q8mp9tfhs04fxznruqw2dh6jj7s40etwadugkh4""},{""type"":0,""spent"":true,""value"":1428746,""spending_outpoints"":[{""tx_index"":1662833166199075,""n"":3}],""n"":5,""tx_index"":1736821424630792,""script"":""76a914de340ac1da07e5620f105577f88b81623ee046bf88ac"",""addr"":""1MFuMXhehYv9Rs6Xyyma6QYCvUyrC3bPUx""},{""type"":0,""spent"":false,""value"":1351,""spending_outpoints"":[],""n"":6,""tx_index"":1736821424630792,""script"":""76a914a0b0d60e5991578ed37cbda2b17d8b2ce23ab29588ac"",""addr"":""1FeexV6bAHb8ybZjqQMjJrcCrHGW9sb6uF""},{""type"":0,""spent"":true,""value"":1479256,""spending_outpoints"":[{""tx_index"":3913381526232650,""n"":0}],""n"":7,""tx_index"":1736821424630792,""script"":""76a914eb20ea3781cba730709587875b00e542bf4e87e088ac"",""addr"":""1NSFE3nyzsZMS8LZD1JnYZmcdbkVQxQKiZ""},{""type"":0,""spent"":true,""value"":77645,""spending_outpoints"":[{""tx_index"":7972554656155240,""n"":4}],""n"":8,""tx_index"":1736821424630792,""script"":""0014e13ad6da9d623c84ff3c19e489315874e8c78e01"",""addr"":""bc1quyaddk5avg7gfleur8jgjv2cwn5v0rsp9vwrs3""},{""type"":0,""spent"":false,""value"":1810160,""spending_outpoints"":[],""n"":9,""tx_index"":1736821424630792,""script"":""00149cc56ef7c6e4bf51c9be9454694abc2e8545e88c"",""addr"":""bc1qnnzkaa7xujl4rjd7j32xjj4u96z5t6yv72l75p""},{""type"":0,""spent"":true,""value"":141344,""spending_outpoints"":[{""tx_index"":1129440303996790,""n"":55}],""n"":10,""tx_index"":1736821424630792,""script"":""a914ccb933d41a61253c890df2d168b28c2a7bc15fed87"",""addr"":""3LMVdmaJqQ5bS1eRihQphMs1Y8bNTKMjCz""},{""type"":0,""spent"":true,""value"":71700,""spending_outpoints"":[{""tx_index"":1893360637152609,""n"":443}],""n"":11,""tx_index"":1736821424630792,""script"":""001467c137079bacdfd66f7044fdd3d3e245c958003a"",""addr"":""bc1qvlqnwpum4n0avmmsgn7a85lzghy4sqp660gzwe""},{""type"":0,""spent"":true,""value"":242958,""spending_outpoints"":[{""tx_index"":647913217070137,""n"":0}],""n"":12,""tx_index"":1736821424630792,""script"":""0014b98bdecc83a388236fe5a3ee79441359ffa52d01"",""addr"":""bc1qhx9aanyr5wyzxml950h8j3qnt8l62tgpeadq82""},{""type"":0,""spent"":true,""value"":3559843,""spending_outpoints"":[{""tx_index"":6521484450939292,""n"":1}],""n"":13,""tx_index"":1736821424630792,""script"":""0014c7f0b42274126475b1d9f8c10c33bd11eced7b56"",""addr"":""bc1qclctggn5zfj8tvwelrqscvaaz8kw676kn7fm8p""},{""type"":0,""spent"":true,""value"":831902,""spending_outpoints"":[{""tx_index"":5973603700548206,""n"":4}],""n"":14,""tx_index"":1736821424630792,""script"":""76a914ca5b909b583132387a73c404be4d5b505927d40288ac"",""addr"":""1KSyBnjRMcURXEMdx2n9KqidNP4gRhqMQ2""},{""type"":0,""spent"":true,""value"":362168,""spending_outpoints"":[{""tx_index"":1078768999270069,""n"":401}],""n"":15,""tx_index"":1736821424630792,""script"":""a91445e0e81f2a0995e3c87169dc07594c0bb8f2a52e87"",""addr"":""384VyaCq5mtYSBDUmAS1YMeVQtaAyX3ghT""},{""type"":0,""spent"":true,""value"":16745562,""spending_outpoints"":[{""tx_index"":6654163819514758,""n"":1}],""n"":16,""tx_index"":1736821424630792,""script"":""0014dbd61df7e665b2e1108d7964a9e01aee0f50fe95"",""addr"":""bc1qm0tpmalxvkewzyyd09j2ncq6ac84pl54uyexy6""},{""type"":0,""spent"":true,""value"":200123,""spending_outpoints"":[{""tx_index"":2496969209218682,""n"":97}],""n"":17,""tx_index"":1736821424630792,""script"":""a914a1c15b1535497b70d13d8d216679cfe708e7102e87"",""addr"":""3GSJM2NS2Sm8w1u8mSgYH3DEqUU9HSxUsR""},{""type"":0,""spent"":true,""value"":438158,""spending_outpoints"":[{""tx_index"":4706171029355531,""n"":2}],""n"":18,""tx_index"":1736821424630792,""script"":""001464eb0a33ae8f7dddeb9da9de9dfc8582567a25af"",""addr"":""bc1qvn4s5vaw3a7am6ua480fmly9sft85fd09zzl7h""},{""type"":0,""spent"":true,""value"":413574094,""spending_outpoints"":[{""tx_index"":8317785776701280,""n"":0}],""n"":19,""tx_index"":1736821424630792,""script"":""001408da93bfad48bddcdaf49e65248c3195a1838caa"",""addr"":""bc1qprdf80adfz7aekh5nejjfrp3jksc8r929svpxk""}]",1351,7995725285202
"4a4c0e87e1fdf58de68ec1e2b11f533033a3c0cbd629081ed3b59f62a6aa0432",1,1,21,843,3042,301391,"0.0.0.0",0,1759859977245686,false,1683168279,788181,788181,"[{""sequence"":4294967295,""witness"":""02483045022100c7f00d78cc09bcccbdc213897a6a8dd30fcd3d10f8bbc3c9702326eeb7ffdb0f0220120621c9f28428bb7fa2bf15255ca19dabe905e786697b8a4be958a1addd12a10121022a51bd8200f44d72e94fa623ad6f79efb10fa6a873b5a8cf1c63b47f6301729b"",""script"":"""",""index"":0,""prev_out"":{""addr"":""bc1qprdf80adfz7aekh5nejjfrp3jksc8r929svpxk"",""n"":20,""script"":""001408da93bfad48bddcdaf49e65248c3195a1838caa"",""spending_outpoints"":[{""n"":0,""tx_index"":1759859977245686}],""spent"":true,""tx_index"":524795793418588,""type"":0,""value"":22395956037}}]","[{""type"":0,""spent"":false,""value"":17000000,""spending_outpoints"":[],""n"":0,""tx_index"":1759859977245686,""script"":""001442ce8f9adea4c56166a17bc30f48a4bea689ec2e"",""addr"":""bc1qgt8glxk75nzkze4p00ps7j9yh6ngnmpwyw5xn7""},{""type"":0,""spent"":false,""value"":1351,""spending_outpoints"":[],""n"":1,""tx_index"":1759859977245686,""script"":""76a914a0b0d60e5991578ed37cbda2b17d8b2ce23ab29588ac"",""addr"":""1FeexV6bAHb8ybZjqQMjJrcCrHGW9sb6uF""},{""type"":0,""spent"":true,""value"":17000000,""spending_outpoints"":[{""tx_index"":4194805835810310,""n"":15}],""n"":2,""tx_index"":1759859977245686,""script"":""a914861bb828a94d7b7b4c73df506651c813114ef9ee87"",""addr"":""3Dv7gDyzAAd3CY3i1TayRb7BctWp2BJpFU""},{""type"":0,""spent"":true,""value"":53288,""spending_outpoints"":[{""tx_index"":825984371122904,""n"":1}],""n"":3,""tx_index"":1759859977245686,""script"":""0014bc0bacd2d623118d47fe3f068ffcc8eaf099f3c5"",""addr"":""bc1qhs96e5kkyvgc63l78urgllxgatcfnu79suad3e""},{""type"":0,""spent"":true,""value"":1030434,""spending_outpoints"":[{""tx_index"":2467789089396347,""n"":14}],""n"":4,""tx_index"":1759859977245686,""script"":""00146453797768be53266735eda167143b6c7c39e74b"",""addr"":""bc1qv3fhjamghefjvee4akskw9pmd37rne6tkutkqn""},{""type"":0,""spent"":true,""value"":36210,""spending_outpoints"":[{""tx_index"":7095641945509508,""n"":13}],""n"":5,""tx_index"":1759859977245686,""script"":""a9145fd2a7ef81784a42a79a7ca8c118dcdd1745757187"",""addr"":""3ARgUQKxcuyLRMXbbwqPcThXhaNwhP4e94""},{""type"":0,""spent"":true,""value"":200000,""spending_outpoints"":[{""tx_index"":7558410388441473,""n"":426}],""n"":6,""tx_index"":1759859977245686,""script"":""a91463be907a6ea5e2ed01d35dcb29c5cd19c1d91b7b87"",""addr"":""3AnR7BMik56fXhDDLMSmhVFDJT6YSVqCs3""},{""type"":0,""spent"":true,""value"":344400,""spending_outpoints"":[{""tx_index"":6250833781385083,""n"":4}],""n"":7,""tx_index"":1759859977245686,""script"":""0014e75f0a21bcc77db36222d6db80f30617d10b642f"",""addr"":""bc1qua0s5gduca7mxc3z6mdcpucxzlgskep0dazue9""},{""type"":0,""spent"":true,""value"":3604584,""spending_outpoints"":[{""tx_index"":760760164234147,""n"":0}],""n"":8,""tx_index"":1759859977245686,""script"":""00142d9ba3265573b821b98a7b3e7ef97200cd0e98dd"",""addr"":""bc1q9kd6xfj4wwuzrwv20vl8a7tjqrxsaxxatnh8la""},{""type"":0,""spent"":true,""value"":158240,""spending_outpoints"":[{""tx_index"":3279692910216220,""n"":37}],""n"":9,""tx_index"":1759859977245686,""script"":""0020eabae1eb6ce0eda9de67a8ca5315b833e69e61fdb6426fa5041b89d5bace30db"",""addr"":""bc1qa2awr6mvurk6nhn84r99x9dcx0nfuc0akepxlfgyrwyatwkwxrds9lqkus""},{""type"":0,""spent"":true,""value"":178562,""spending_outpoints"":[{""tx_index"":6664994914952186,""n"":2}],""n"":10,""tx_index"":1759859977245686,""script"":""76a9144c753bf6317f1264af5c5f7eb0867c85ce19310488ac"",""addr"":""17yGoA3RKtsGr5p61kNGHEPx2kZWMHMhrK""},{""type"":0,""spent"":true,""value"":226583,""spending_outpoints"":[{""tx_index"":8647826616277817,""n"":230}],""n"":11,""tx_index"":1759859977245686,""script"":""a914502c200d12e7ec16b31f4dafc2c50169247cb1eb87"",""addr"":""38zvqmCJPJKCKTgEr17YczHRLH3egRA5nc""},{""type"":0,""spent"":true,""value"":1784828,""spending_outpoints"":[{""tx_index"":901553089646365,""n"":0}],""n"":12,""tx_index"":1759859977245686,""script"":""0014d47106538b13af94df26100c46221fb31f860c14"",""addr"":""bc1q63csv5utzwhefhexzqxyvgslkv0cvrq56aeecd""},{""type"":0,""spent"":true,""value"":301299,""spending_outpoints"":[{""tx_index"":6795021683980169,""n"":19}],""n"":13,""tx_index"":1759859977245686,""script"":""0014ccdce8f32cf899bfbf0e09bf6e30ca5cf1f643c4"",""addr"":""bc1qenww3uevlzvml0cwpxlkuvx2tnclvs7y4xwv0z""},{""type"":0,""spent"":true,""value"":1000125,""spending_outpoints"":[{""tx_index"":3577228218386179,""n"":1}],""n"":14,""tx_index"":1759859977245686,""script"":""76a9146ee63cec64de485e8ad4e27a4820d1f7986d0a2288ac"",""addr"":""1B7P9KNgqKikHVwdZc8tpMmwUxRoF3kNwQ""},{""type"":0,""spent"":true,""value"":700000,""spending_outpoints"":[{""tx_index"":1906427545776500,""n"":30}],""n"":15,""tx_index"":1759859977245686,""script"":""00147c4e3790da82d37b97e92a21746bcfb951ba9f28"",""addr"":""bc1q038r0yx6stfhh9lf9gshg670h9gm48egp6crqk""},{""type"":0,""spent"":true,""value"":68657,""spending_outpoints"":[{""tx_index"":669225109381022,""n"":589}],""n"":16,""tx_index"":1759859977245686,""script"":""a9147d27c087b93c783db4064ea63216f193bbbc6bf987"",""addr"":""3D6n1YZCC98Msip3Fq6peXoEN4Vv5m76sn""},{""type"":0,""spent"":true,""value"":69196,""spending_outpoints"":[{""tx_index"":1213325289658981,""n"":67}],""n"":17,""tx_index"":1759859977245686,""script"":""a91438feb613e17de727631d0ad0298fb045457baab187"",""addr"":""36tNtw6f5tNWoHUxgq8vH8yqPsT55KvBNG""},{""type"":0,""spent"":true,""value"":138764,""spending_outpoints"":[{""tx_index"":4469058809704539,""n"":16}],""n"":18,""tx_index"":1759859977245686,""script"":""76a91481949d47df765723e189d9b17c3be66ccc357f8788ac"",""addr"":""1CpACewVQrpNZYmcXEjup4DRzmG6DiaVxo""},{""type"":0,""spent"":true,""value"":325222,""spending_outpoints"":[{""tx_index"":2474539470325894,""n"":7}],""n"":19,""tx_index"":1759859977245686,""script"":""a9141ab4904a8dbb38640e539073e4a835776d65773487"",""addr"":""348DoK6c2mLpVK6Jq85CwZpJs7r4nP4Tfk""},{""type"":0,""spent"":true,""value"":22351432903,""spending_outpoints"":[{""tx_index"":9954263493561,""n"":0}],""n"":20,""tx_index"":1759859977245686,""script"":""001408da93bfad48bddcdaf49e65248c3195a1838caa"",""addr"":""bc1qprdf80adfz7aekh5nejjfrp3jksc8r929svpxk""}]",1351,7995725283851
"b9a0ad96125d96def670c5700fb2e1563aba13b03ca5050e2e5c46fefb010b54",1,1,20,800,2873,286264,"0.0.0.0",0,2957000149289163,false,1683154645,788150,788150,"[{""sequence"":4294967295,""witness"":""02473044022058ee925a23b7149336df2a8fc40634a48b6af01d710eac037dea09cc332ee40502201145fd06a98b55aade8776a7e5aae397ea77c74e3bbac1ffe4ec6620b13b5d600121022a51bd8200f44d72e94fa623ad6f79efb10fa6a873b5a8cf1c63b47f6301729b"",""script"":"""",""index"":0,""prev_out"":{""addr"":""bc1qprdf80adfz7aekh5nejjfrp3jksc8r929svpxk"",""n"":20,""script"":""001408da93bfad48bddcdaf49e65248c3195a1838caa"",""spending_outpoints"":[{""n"":0,""tx_index"":2957000149289163}],""spent"":true,""tx_index"":2691755192122259,""type"":0,""value"":22472304706}}]","[{""type"":0,""spent"":false,""value"":16329588,""spending_outpoints"":[],""n"":0,""tx_index"":2957000149289163,""script"":""00142934df2587cdeee2c22223386fc3c14701bc15c7"",""addr"":""bc1q9y6d7fv8ehhw9s3zyvuxls7pguqmc9w88wn4c3""},{""type"":0,""spent"":true,""value"":122196,""spending_outpoints"":[{""tx_index"":4475070002849043,""n"":0}],""n"":1,""tx_index"":2957000149289163,""script"":""001408dcf01ae77d9458d0e60cc5ab642abe6119b1f0"",""addr"":""bc1qprw0qxh80k29358xpnz6kep2hes3nv0srlr02s""},{""type"":0,""spent"":true,""value"":256354,""spending_outpoints"":[{""tx_index"":3580562190915568,""n"":155}],""n"":2,""tx_index"":2957000149289163,""script"":""a914323dda76f67d3772dd2d66b0ceb329924fb516a287"",""addr"":""36GfonPHKgkx5e8qq7BzocvJDVhFJjmzSj""},{""type"":0,""spent"":true,""value"":52719,""spending_outpoints"":[{""tx_index"":7095641945509508,""n"":746}],""n"":3,""tx_index"":2957000149289163,""script"":""a914a3b36997e8afbdf59745eb7600e21e71d87ed82187"",""addr"":""3GcazcJ91Bt7BHEnM9MHthqLR7KDHuodPk""},{""type"":0,""spent"":true,""value"":1201482,""spending_outpoints"":[{""tx_index"":2340511994301212,""n"":990}],""n"":4,""tx_index"":2957000149289163,""script"":""a914b30987263eec08679590fd9ea8636164fd575b5e87"",""addr"":""3J1gHtmdw1vCBb5ttsdqgCWEWPEfAcprcw""},{""type"":0,""spent"":true,""value"":10319,""spending_outpoints"":[{""tx_index"":3448157596213731,""n"":3}],""n"":5,""tx_index"":2957000149289163,""script"":""00145ce6decd5837aaac0d45226428d6f73d773fef13"",""addr"":""bc1qtnndan2cx742cr29yfjz34hh84mnlmcnwl0d4c""},{""type"":0,""spent"":true,""value"":127196,""spending_outpoints"":[{""tx_index"":5792053810434960,""n"":1052}],""n"":6,""tx_index"":2957000149289163,""script"":""00140a1fb5e62c7b42c0a4679ada65685961414e1093"",""addr"":""bc1qpg0mte3v0dpvpfr8ntdx26zev9q5uyyndmvvch""},{""type"":0,""spent"":true,""value"":92085,""spending_outpoints"":[{""tx_index"":8711028441433652,""n"":57}],""n"":7,""tx_index"":2957000149289163,""script"":""76a914bc65db6475baa975739f16c29b93f8bd2d8b450688ac"",""addr"":""1JBA4DLQJSJSecqANgGPhpmNAn9qbHWQBR""},{""type"":0,""spent"":true,""value"":3439366,""spending_outpoints"":[{""tx_index"":1892217490638411,""n"":1}],""n"":8,""tx_index"":2957000149289163,""script"":""76a914a867f94ad01deb375982df208765699240a590ff88ac"",""addr"":""1GMT5TK1tYpmbPCNSHqsZk7unJPJ6c6wwp""},{""type"":0,""spent"":true,""value"":171898,""spending_outpoints"":[{""tx_index"":8864589161595972,""n"":0}],""n"":9,""tx_index"":2957000149289163,""script"":""76a914ef88e5b4e322143b0f3d7ccc49b2f1d2918a4a7b88ac"",""addr"":""1NqYVe1Kqd5EN8trERkiRC4NSCEZBErXTN""},{""type"":0,""spent"":true,""value"":165106,""spending_outpoints"":[{""tx_index"":6671288639783295,""n"":5}],""n"":10,""tx_index"":2957000149289163,""script"":""00140e187bdc904590ae646f9f57e2eff3d41dbf7a0c"",""addr"":""bc1qpcv8hhysgkg2uer0nat79mln6swm77svt9tlqh""},{""type"":0,""spent"":false,""value"":1351,""spending_outpoints"":[],""n"":11,""tx_index"":2957000149289163,""script"":""76a914a0b0d60e5991578ed37cbda2b17d8b2ce23ab29588ac"",""addr"":""1FeexV6bAHb8ybZjqQMjJrcCrHGW9sb6uF""},{""type"":0,""spent"":true,""value"":53562,""spending_outpoints"":[{""tx_index"":7095641945509508,""n"":779}],""n"":12,""tx_index"":2957000149289163,""script"":""a914a14c5494a56fa546bae8096c89e4664a2c6dfa5987"",""addr"":""3GPt9xU6CVAhUimuS8pBgLjfgCR7oJLCxV""},{""type"":0,""spent"":true,""value"":55029,""spending_outpoints"":[{""tx_index"":2326299224446275,""n"":175}],""n"":13,""tx_index"":2957000149289163,""script"":""a914b3cf9dca62605c27fef63926064718c67b1f0c6687"",""addr"":""3J5mbKVX4XwZWMdDZG8DSHdeHfjW13QZHG""},{""type"":0,""spent"":true,""value"":860095,""spending_outpoints"":[{""tx_index"":2331421202990327,""n"":22}],""n"":14,""tx_index"":2957000149289163,""script"":""a914021525e590160fc9ea5637c08f9d9a07467320cf87"",""addr"":""31t2cKRyFCoYsXTNWS41PhGfiBRcE3gwwc""},{""type"":0,""spent"":true,""value"":171910,""spending_outpoints"":[{""tx_index"":7944405811011835,""n"":492}],""n"":15,""tx_index"":2957000149289163,""script"":""a914ed4c5c84fe6c6d73492edd880d953a46df1ba3fb87"",""addr"":""3PKjYh2cRFn59Nx3Xho518ozjpv57egPYJ""},{""type"":0,""spent"":true,""value"":416859,""spending_outpoints"":[{""tx_index"":3690316008748686,""n"":1}],""n"":16,""tx_index"":2957000149289163,""script"":""001407fcdfa36ba654640d10241aeddfff14a8bd4e22"",""addr"":""bc1qql7dlgmt5e2xgrgsysdwmhllzj5t6n3zltq2k2""},{""type"":0,""spent"":true,""value"":1993746,""spending_outpoints"":[{""tx_index"":7077706818701507,""n"":32}],""n"":17,""tx_index"":2957000149289163,""script"":""0014efbc6e5c56dc9354f7a1df40ced83ea45f696881"",""addr"":""bc1qa77xuhzkmjf4faapmaqvakp7530kj6yp0ms5kw""},{""type"":0,""spent"":true,""value"":1373283,""spending_outpoints"":[{""tx_index"":2499933639288588,""n"":15}],""n"":18,""tx_index"":2957000149289163,""script"":""a914ef6a6540f6558352a7b3d96d6248820485deae8087"",""addr"":""3PWvst6P1K9iP9EimEGQZS1dKk4LrCdxrw""},{""type"":0,""spent"":true,""value"":22445124298,""spending_outpoints"":[{""tx_index"":2549190154858122,""n"":0}],""n"":19,""tx_index"":2957000149289163,""script"":""001408da93bfad48bddcdaf49e65248c3195a1838caa"",""addr"":""bc1qprdf80adfz7aekh5nejjfrp3jksc8r929svpxk""}]",1351,7995725282500
"b6d7bbe6f98234729aa9519c88e6edf5588817608a12b74cf9e8d863432cc003",1,1,19,775,2773,90000,"0.0.0.0",0,131965158980381,false,1682994887,787902,787902,"[{""sequence"":4294967295,""witness"":""0247304402201be6799e44d914de23e0b065fce34d499b060e20ff5b039760547da106f221570220068aaebc8b03caa83d8aa91fa53f5e02baeaa8d367eb20f805207d24868307a60121022a51bd8200f44d72e94fa623ad6f79efb10fa6a873b5a8cf1c63b47f6301729b"",""script"":"""",""index"":0,""prev_out"":{""addr"":""bc1qprdf80adfz7aekh5nejjfrp3jksc8r929svpxk"",""n"":20,""script"":""001408da93bfad48bddcdaf49e65248c3195a1838caa"",""spending_outpoints"":[{""n"":0,""tx_index"":131965158980381}],""spent"":true,""tx_index"":5178525348983446,""type"":0,""value"":1201450262}}]","[{""type"":0,""spent"":true,""value"":17860,""spending_outpoints"":[{""tx_index"":1048931802907138,""n"":0}],""n"":0,""tx_index"":131965158980381,""script"":""00142b6808ffe4180df8955ea8a6e895125f8241e5bc"",""addr"":""bc1q9d5q3llyrqxl39274znw39gjt7pyredupwthwv""},{""type"":0,""spent"":true,""value"":16025092,""spending_outpoints"":[{""tx_index"":2624698261006389,""n"":4}],""n"":1,""tx_index"":131965158980381,""script"":""76a91439b656b8451e2c71694ac72cc24bf1f970fc2c7488ac"",""addr"":""16G9x44QKhPfTZDXfckTuvn8CaqrsNWsDK""},{""type"":0,""spent"":true,""value"":1839531,""spending_outpoints"":[{""tx_index"":7870641701477129,""n"":14}],""n"":2,""tx_index"":131965158980381,""script"":""a914411d2d3fc1c457a43db98460fe354bb71bb9a1bd87"",""addr"":""37dJoFQP2wokqgAjSL3D5PKnUVXXm29fRf""},{""type"":0,""spent"":true,""value"":253323,""spending_outpoints"":[{""tx_index"":3879227376004459,""n"":5}],""n"":3,""tx_index"":131965158980381,""script"":""76a914c17445079580d390688b55a64c01efff6579141388ac"",""addr"":""1Jdthae1xoVesQSgjb8GpyrVULFEmqiWJ5""},{""type"":0,""spent"":false,""value"":3531,""spending_outpoints"":[],""n"":4,""tx_index"":131965158980381,""script"":""76a914a0b0d60e5991578ed37cbda2b17d8b2ce23ab29588ac"",""addr"":""1FeexV6bAHb8ybZjqQMjJrcCrHGW9sb6uF""},{""type"":0,""spent"":true,""value"":704880,""spending_outpoints"":[{""tx_index"":1968590934056121,""n"":0}],""n"":5,""tx_index"":131965158980381,""script"":""a91449deebe22a944ef9c76c054676ea20aa860d296887"",""addr"":""38RcJQ72Cvm9AY94Li33Jp5CyDNVot3xjH""},{""type"":0,""spent"":true,""value"":1068030,""spending_outpoints"":[{""tx_index"":5336350868609005,""n"":1}],""n"":6,""tx_index"":131965158980381,""script"":""00142e96c3d97dc5b18f294d81a2cc92b9b924a202b1"",""addr"":""bc1q96tv8ktackcc722dsx3vey4ehyj2yq43mgpe5l""},{""type"":0,""spent"":true,""value"":101919,""spending_outpoints"":[{""tx_index"":3580199726473578,""n"":45}],""n"":7,""tx_index"":131965158980381,""script"":""0014f542a6a8ad753acd7391d4f3a1c68bc3960bfde0"",""addr"":""bc1q74p2d29dw5av6uu36ne6r35tcwtqhl0qcndnh9""},{""type"":0,""spent"":true,""value"":1586888,""spending_outpoints"":[{""tx_index"":7160169885649500,""n"":1}],""n"":8,""tx_index"":131965158980381,""script"":""76a914a8d33a0080fb94f4b26a82945c01b04638bd9efc88ac"",""addr"":""1GPfZWQDCXHhVZMGN2dLNaRgJ6dJqDGGhr""},{""type"":0,""spent"":false,""value"":679359,""spending_outpoints"":[],""n"":9,""tx_index"":131965158980381,""script"":""0014a9cb9ece284018998efb083658bc28069b98d8bb"",""addr"":""bc1q489ean3ggqvfnrhmpqm930pgq6de3k9m0xwmug""},{""type"":0,""spent"":true,""value"":347156,""spending_outpoints"":[{""tx_index"":8496905705020463,""n"":6}],""n"":10,""tx_index"":131965158980381,""script"":""76a9144fbe7d6d11638cb210b90948c353d8e2bfe9db5e88ac"",""addr"":""18GeadRm1922LAbVrPdNgoQALqTXYYdQFc""},{""type"":0,""spent"":true,""value"":96442,""spending_outpoints"":[{""tx_index"":591749137920817,""n"":272}],""n"":11,""tx_index"":131965158980381,""script"":""76a91453beb65d8e8dccadf40ea579199563c40080ec5788ac"",""addr"":""18doYrGE8XTybcHwmnNud1iKGgsPiroydt""},{""type"":0,""spent"":true,""value"":371301,""spending_outpoints"":[{""tx_index"":2268603376190960,""n"":145}],""n"":12,""tx_index"":131965158980381,""script"":""001404498f44c3fdfd5ec5ff6793f0f010183298d53e"",""addr"":""bc1qq3yc73xrlh74a30lv7flpuqsrqef34f74eyh4y""},{""type"":0,""spent"":true,""value"":287000,""spending_outpoints"":[{""tx_index"":4703161946482136,""n"":0}],""n"":13,""tx_index"":131965158980381,""script"":""00146803d4e05d9ba1db666e69bcfff69b1806767bf2"",""addr"":""bc1qdqpafczanwsakenwdx70la5mrqr8v7ljx6wmzc""},{""type"":0,""spent"":true,""value"":1718162,""spending_outpoints"":[{""tx_index"":5738380766885769,""n"":21}],""n"":14,""tx_index"":131965158980381,""script"":""a914c6f285497a36bdc059001dbcd9193037fd669d4b87"",""addr"":""3KpxFA2nN7opUHYJSf9VkhLkwZNzXnGdop""},{""type"":0,""spent"":true,""value"":83742,""spending_outpoints"":[{""tx_index"":3361819744364024,""n"":542}],""n"":15,""tx_index"":131965158980381,""script"":""a9147a727dd41637684f064c4354d4680c2dc3d20f2a87"",""addr"":""3CrTWxU8XMerbCYr36NirSZBqPhp8jK8Cr""},{""type"":0,""spent"":true,""value"":78345,""spending_outpoints"":[{""tx_index"":1507564234271430,""n"":82}],""n"":16,""tx_index"":131965158980381,""script"":""76a914398c3e6def4b2817603a0844b17f0f515053b16388ac"",""addr"":""16FHXFSJesNP2bvMs3nAxEmVMFW8kGim1g""},{""type"":0,""spent"":true,""value"":349829,""spending_outpoints"":[{""tx_index"":7466468038839776,""n"":205}],""n"":17,""tx_index"":131965158980381,""script"":""a914edd1d9936ae263474e06f166dfad90893c6dcb2687"",""addr"":""3PNVTdm8UBoFCDNLmHNTn7kkZKv2Ayq6G9""},{""type"":0,""spent"":true,""value"":1175747872,""spending_outpoints"":[{""tx_index"":5639116805772505,""n"":0}],""n"":18,""tx_index"":131965158980381,""script"":""001408da93bfad48bddcdaf49e65248c3195a1838caa"",""addr"":""bc1qprdf80adfz7aekh5nejjfrp3jksc8r929svpxk""}]",3531,7995725281149
"4676a70e209102862ccf7166d22699c6dd00fbc482bdd157edc17794e29933c6",1,1,20,812,2918,96794,"0.0.0.0",0,6973597676637944,false,1682966646,787850,787850,"[{""sequence"":4294967295,""witness"":""02483045022100d5c1088f52c2ca472c068430b754f7bf3d8d84165bebdd32b0c3f954ea6c0ce80220141b2b4c7a4435ef945875d02fa364dde94972eb9a650dd026ae0599c536baa30121022a51bd8200f44d72e94fa623ad6f79efb10fa6a873b5a8cf1c63b47f6301729b"",""script"":"""",""index"":0,""prev_out"":{""addr"":""bc1qprdf80adfz7aekh5nejjfrp3jksc8r929svpxk"",""n"":20,""script"":""001408da93bfad48bddcdaf49e65248c3195a1838caa"",""spending_outpoints"":[{""n"":0,""tx_index"":6973597676637944}],""spent"":true,""tx_index"":546752599480664,""type"":0,""value"":2407641973}}]","[{""type"":0,""spent"":true,""value"":3291134,""spending_outpoints"":[{""tx_index"":6411935883739885,""n"":1}],""n"":0,""tx_index"":6973597676637944,""script"":""001454912cc91804913585f5dc1d3d2429557db3b2e6"",""addr"":""bc1q2jgjejgcqjgntp04mswn6fpf247m8vhxncj74y""},{""type"":0,""spent"":true,""value"":582983,""spending_outpoints"":[{""tx_index"":5161933689869382,""n"":2}],""n"":1,""tx_index"":6973597676637944,""script"":""76a91461230b351521c8d6bc37ffde9e54c37688e9e90088ac"",""addr"":""19rcXVY2mvgcywZ6ng4riXQG86qWX7cVHK""},{""type"":0,""spent"":false,""value"":976012,""spending_outpoints"":[],""n"":2,""tx_index"":6973597676637944,""script"":""76a914ca323b2e8f823f1fba1c55cf20e9fc59cc7df9ec88ac"",""addr"":""1KS7fseevHT8zjqEjcaZJT7PV4845tc15b""},{""type"":0,""spent"":true,""value"":2447537,""spending_outpoints"":[{""tx_index"":761369951779366,""n"":39}],""n"":3,""tx_index"":6973597676637944,""script"":""76a91429af7c55c07dcacafc50d99a24f46be871ec59ca88ac"",""addr"":""14oQvpoFB1PJTpWm5dZ3NEQHo6EUgihK8Z""},{""type"":0,""spent"":true,""value"":1738287,""spending_outpoints"":[{""tx_index"":660082216189341,""n"":0}],""n"":4,""tx_index"":6973597676637944,""script"":""76a9141e4d10de349ab55b627fb7ca12f8432b9a792bda88ac"",""addr"":""13mDbPSQiqsBkTJo2GVD7ntWsYCEYH9oyw""},{""type"":0,""spent"":true,""value"":347269,""spending_outpoints"":[{""tx_index"":3875061444408742,""n"":7}],""n"":5,""tx_index"":6973597676637944,""script"":""00141a85668a21e7d2c611e775d12818cc70a590986d"",""addr"":""bc1qr2zkdz3pulfvvy08whgjsxxvwzjepxrdtpxc0k""},{""type"":0,""spent"":false,""value"":5086,""spending_outpoints"":[],""n"":6,""tx_index"":6973597676637944,""script"":""76a914a0b0d60e5991578ed37cbda2b17d8b2ce23ab29588ac"",""addr"":""1FeexV6bAHb8ybZjqQMjJrcCrHGW9sb6uF""},{""type"":0,""spent"":true,""value"":53054,""spending_outpoints"":[{""tx_index"":907585916985479,""n"":5}],""n"":7,""tx_index"":6973597676637944,""script"":""76a91481e4e0428a43d1a605b23bb1f3994db302cfa1cb88ac"",""addr"":""1CqpMLAfek4z9bEBoLdorxDtbUh8ZLyFZD""},{""type"":0,""spent"":true,""value"":707357,""spending_outpoints"":[{""tx_index"":1105468248804330,""n"":604}],""n"":8,""tx_index"":6973597676637944,""script"":""a9140ca75c255c027fe3e5913124217b23b05bcafadd87"",""addr"":""32qvXDdVTjEWLSajv7RJLacujXraP1ruLE""},{""type"":0,""spent"":true,""value"":69895,""spending_outpoints"":[{""tx_index"":7228428700634621,""n"":830}],""n"":9,""tx_index"":6973597676637944,""script"":""a9143141dc9fb6bd8b6c5b6df7e66834966c86f004d387"",""addr"":""36BTw6tdLeJjFBKj2fw2D2m7YNTjk1iXXT""},{""type"":0,""spent"":true,""value"":80000,""spending_outpoints"":[{""tx_index"":3361819744364024,""n"":285}],""n"":10,""tx_index"":6973597676637944,""script"":""a914a1d137ba8054a26671a988cbad00a07c273fd9b987"",""addr"":""3GSdM8Q5LUyrV1GM2p1uaRqfgnL5NQKyeQ""},{""type"":0,""spent"":true,""value"":25216,""spending_outpoints"":[{""tx_index"":2455942020751421,""n"":15}],""n"":11,""tx_index"":6973597676637944,""script"":""76a914e2dbda316f436f858a6114416a4bbcbc9a05fb0288ac"",""addr"":""1MgX5xhwcDcY7UrFfdU9DqjNt3npxPqYhC""},{""type"":0,""spent"":true,""value"":229959,""spending_outpoints"":[{""tx_index"":1394789855644143,""n"":832}],""n"":12,""tx_index"":6973597676637944,""script"":""a9142dd9a30712dfd95a019c4ab2df67fe5fcac4744187"",""addr"":""35sT3r8jEgKFHKrYqy5y1KTZSvvkP2YbcM""},{""type"":0,""spent"":true,""value"":35370,""spending_outpoints"":[{""tx_index"":2347772439566136,""n"":74}],""n"":13,""tx_index"":6973597676637944,""script"":""a914916d9828337901ef87354183cab0e721806a863787"",""addr"":""3EwyC7H2qEE46rK1hkCDsWq4bHhjbLvBPc""},{""type"":0,""spent"":true,""value"":159185,""spending_outpoints"":[{""tx_index"":2486907919783644,""n"":154}],""n"":14,""tx_index"":6973597676637944,""script"":""0014154d35b4ec0602fde7b28197e4494b6b5d21b82d"",""addr"":""bc1qz4xntd8vqcp0meajsxt7gj2tddwjrwpd0ngnzq""},{""type"":0,""spent"":true,""value"":79294,""spending_outpoints"":[{""tx_index"":3517257893837009,""n"":10}],""n"":15,""tx_index"":6973597676637944,""script"":""76a9147e5d32c47e2c2b222d500013bfbb808fd4df178c88ac"",""addr"":""1CX9nhmBBQ62KLjweov5JJdumWcdTtJpC5""},{""type"":0,""spent"":false,""value"":10000000,""spending_outpoints"":[],""n"":16,""tx_index"":6973597676637944,""script"":""0014b44e29085a1b9dd5d1ea1d4eb1059a118aca51cb"",""addr"":""bc1qk38zjzz6rwwat502r48tzpv6zx9v55wtnammrm""},{""type"":0,""spent"":true,""value"":643597,""spending_outpoints"":[{""tx_index"":3433244815280256,""n"":69}],""n"":17,""tx_index"":6973597676637944,""script"":""a914f2b1b3364fd0d029897c211f9b6662f375c8c9a787"",""addr"":""3PpGKnLUgDiywgPgv6LUkR7YhUYd6R3gaZ""},{""type"":0,""spent"":true,""value"":729712,""spending_outpoints"":[{""tx_index"":4394408305128323,""n"":19}],""n"":18,""tx_index"":6973597676637944,""script"":""a91475574935e10025079ac22477d9e6528dc178ef1a87"",""addr"":""3CPTYiwqBedGvxBwzHMK6py9UBmR7Jis5M""},{""type"":0,""spent"":true,""value"":2385344232,""spending_outpoints"":[{""tx_index"":8216410974129633,""n"":0}],""n"":19,""tx_index"":6973597676637944,""script"":""001408da93bfad48bddcdaf49e65248c3195a1838caa"",""addr"":""bc1qprdf80adfz7aekh5nejjfrp3jksc8r929svpxk""}]",5086,7995725277618
"9e0fb07b332f333c408e449dcdac7ed147debc5af8c606d0a36258bfe187edcb",1,1,21,837,3018,81240,"0.0.0.0",0,7175073517005580,false,1682792406,787521,787521,"[{""sequence"":4294967295,""witness"":""02483045022100f00a2400944d8e827bf492d2c25e703c1a5d13eb04826fadcb99b77b4c49435e02207c55ccdab4b73caa5d45e083edfd01a07aca5bd53b1e5b200a32ce6b17ce03a10121022a51bd8200f44d72e94fa623ad6f79efb10fa6a873b5a8cf1c63b47f6301729b"",""script"":"""",""index"":0,""prev_out"":{""addr"":""bc1qprdf80adfz7aekh5nejjfrp3jksc8r929svpxk"",""n"":20,""script"":""001408da93bfad48bddcdaf49e65248c3195a1838caa"",""spending_outpoints"":[{""n"":0,""tx_index"":7175073517005580}],""spent"":true,""tx_index"":3710504756077585,""type"":0,""value"":7051169695}}]","[{""type"":0,""spent"":true,""value"":701260,""spending_outpoints"":[{""tx_index"":7074707010164577,""n"":250}],""n"":0,""tx_index"":7175073517005580,""script"":""a9147973f60b744af91d44886804bbc25d2b1b949af187"",""addr"":""3CmCbsgJ546ZR1SA4BCP3tLhCNZifeTd7w""},{""type"":0,""spent"":true,""value"":5000000,""spending_outpoints"":[{""tx_index"":946784848208523,""n"":1}],""n"":1,""tx_index"":7175073517005580,""script"":""76a91476202619bec6db374d533c71a3cd95a405802f4888ac"",""addr"":""1BmbFNoU2gxoNsdP6htFn1usvpc96XikSJ""},{""type"":0,""spent"":true,""value"":85567,""spending_outpoints"":[{""tx_index"":489662334748784,""n"":0}],""n"":2,""tx_index"":7175073517005580,""script"":""00148c30f0daeb41c2251b6f7050e1a14bdf91b0736a"",""addr"":""bc1q3sc0pkhtg8pz2xm0wpgwrg2tm7gmqum2qumt5r""},{""type"":0,""spent"":true,""value"":5226324,""spending_outpoints"":[{""tx_index"":3856951802902463,""n"":31}],""n"":3,""tx_index"":7175073517005580,""script"":""a91469a11fecdadc8bb2be4eac478c1490b340396b8487"",""addr"":""3BKXtpuzdKNrJ3bRzVfTFfBWumq7SNBam7""},{""type"":0,""spent"":true,""value"":613016,""spending_outpoints"":[{""tx_index"":2562869255343805,""n"":3}],""n"":4,""tx_index"":7175073517005580,""script"":""76a9144d37b7d6b7ec984592d304e8bf25d0a807726a1d88ac"",""addr"":""183Hn8m6CW5VwxbG4WZVpWscPed28CaKGz""},{""type"":0,""spent"":true,""value"":174475,""spending_outpoints"":[{""tx_index"":3545191757912478,""n"":151}],""n"":5,""tx_index"":7175073517005580,""script"":""a91455f7592ab0a89a75021db39ad4c1a52b875ab88d87"",""addr"":""39XZfuo1pmpGHwUcVvsnq5RhE6Ht6fCWZL""},{""type"":0,""spent"":true,""value"":678021,""spending_outpoints"":[{""tx_index"":6954791547906242,""n"":44}],""n"":6,""tx_index"":7175073517005580,""script"":""76a9148f78903c101318701835c3f3ce83d345d177af3488ac"",""addr"":""1E5c4KqaJJUiieDDxMX7m1vVnhp5sVsUCg""},{""type"":0,""spent"":true,""value"":2940000,""spending_outpoints"":[{""tx_index"":3895372830457445,""n"":101}],""n"":7,""tx_index"":7175073517005580,""script"":""76a914f1ede1e2285e1bca2f661ea62e7e5b9ab0d404bf88ac"",""addr"":""1P4Cpb3tob13LJnczDWt6bv3wDu7Lc9Jkv""},{""type"":0,""spent"":true,""value"":34232,""spending_outpoints"":[{""tx_index"":4535710654422547,""n"":355}],""n"":8,""tx_index"":7175073517005580,""script"":""a914681d899c93d8d385e4387010499f2ae4895a149687"",""addr"":""3BBXaoHG3iYnuAaSLx1moAMT75pFd7Cqxz""},{""type"":0,""spent"":true,""value"":118072,""spending_outpoints"":[{""tx_index"":6621817737421118,""n"":24}],""n"":9,""tx_index"":7175073517005580,""script"":""0014fe9d2e2025e362a6260ec79e54dd96a974b482ef"",""addr"":""bc1ql6wjugp9ud32vfswc709fhvk496tfqh0wdpmec""},{""type"":0,""spent"":false,""value"":139227,""spending_outpoints"":[],""n"":10,""tx_index"":7175073517005580,""script"":""0014a7888d2512f26019245242885d207c63f8c88948"",""addr"":""bc1q57yg6fgj7fspjfzjg2y96gruv0uv3z2gt9q3kl""},{""type"":0,""spent"":true,""value"":101894,""spending_outpoints"":[{""tx_index"":1937620831246990,""n"":139}],""n"":11,""tx_index"":7175073517005580,""script"":""a914ec96584268deac4ec4bbdfb4a8306c754506273c87"",""addr"":""3PFyVxEDiWj1kFoeLbt7bu8wk4C6hnQP71""},{""type"":0,""spent"":true,""value"":166402,""spending_outpoints"":[{""tx_index"":3848805355765213,""n"":267}],""n"":12,""tx_index"":7175073517005580,""script"":""0014ab056632acf6fb3b838d5927aff44007eca6e37e"",""addr"":""bc1q4vzkvv4v7manhqudtyn6lazqqlk2dcm7sj5stp""},{""type"":0,""spent"":false,""value"":1351,""spending_outpoints"":[],""n"":13,""tx_index"":7175073517005580,""script"":""76a914a0b0d60e5991578ed37cbda2b17d8b2ce23ab29588ac"",""addr"":""1FeexV6bAHb8ybZjqQMjJrcCrHGW9sb6uF""},{""type"":0,""spent"":true,""value"":183402,""spending_outpoints"":[{""tx_index"":1614837420773558,""n"":195}],""n"":14,""tx_index"":7175073517005580,""script"":""a914c5a629f7fe69b981ddc89e14643562f79c9a167b87"",""addr"":""3Ki66cBHhZRojYbS3jAJoAFTgJ3YQzeAGo""},{""type"":0,""spent"":true,""value"":1346578,""spending_outpoints"":[{""tx_index"":2656288578988114,""n"":0}],""n"":15,""tx_index"":7175073517005580,""script"":""0014f6947d0216c115d45ac89f0cd58ef80d9394d0fa"",""addr"":""bc1q76286qskcy2agkkgnuxdtrhcpkfef5866kkh9d""},{""type"":0,""spent"":true,""value"":171075,""spending_outpoints"":[{""tx_index"":4877828062445573,""n"":705}],""n"":16,""tx_index"":7175073517005580,""script"":""a914904d719fc569261ef5181d2987b18e5ceefb1d8887"",""addr"":""3Er214RxbnC1pfpRNhjuXwQjqAZG1PhDXw""},{""type"":0,""spent"":true,""value"":230000,""spending_outpoints"":[{""tx_index"":522835583669191,""n"":0}],""n"":17,""tx_index"":7175073517005580,""script"":""00145043f1a3048ab8be1b8297df3ff41027dec56964"",""addr"":""bc1q2pplrgcy32utuxuzjl0nlaqsyl0v26tydpz25p""},{""type"":0,""spent"":true,""value"":4008546,""spending_outpoints"":[{""tx_index"":8945957275008669,""n"":1}],""n"":18,""tx_index"":7175073517005580,""script"":""0014d208bdeb00b207e92f4131b50c217f396b20e00f"",""addr"":""bc1q6gytm6cqkgr7jt6pxx6scgtl894jpcq0qv8pep""},{""type"":0,""spent"":true,""value"":41099,""spending_outpoints"":[{""tx_index"":1651052220657692,""n"":1}],""n"":19,""tx_index"":7175073517005580,""script"":""76a9144854f81608d9815f1c1b9664a809bc0f30e95a5c88ac"",""addr"":""17bTSZujfv1oo28JsbuN5W84BRVPdQkmgu""},{""type"":0,""spent"":true,""value"":7029127914,""spending_outpoints"":[{""tx_index"":4515338533415165,""n"":0}],""n"":20,""tx_index"":7175073517005580,""script"":""001408da93bfad48bddcdaf49e65248c3195a1838caa"",""addr"":""bc1qprdf80adfz7aekh5nejjfrp3jksc8r929svpxk""}]",1351,7995725272532
"b47d82874225abe07680e2c8d7d095510824d4e76ab04e51080cda63e4b01b4b",1,1,21,827,2978,76115,"0.0.0.0",0,2642633726655297,false,1682568424,787166,787166,"[{""sequence"":4294967295,""witness"":""0248304502210089809e76ff971db4cef27937719ab96df9b223525c84f9604232caf9904626110220156395b2ee0aa388770b6eb4aabfef51401edf2777690da3930f6108d754e5790121022a51bd8200f44d72e94fa623ad6f79efb10fa6a873b5a8cf1c63b47f6301729b"",""script"":"""",""index"":0,""prev_out"":{""addr"":""bc1qprdf80adfz7aekh5nejjfrp3jksc8r929svpxk"",""n"":20,""script"":""001408da93bfad48bddcdaf49e65248c3195a1838caa"",""spending_outpoints"":[{""n"":0,""tx_index"":2642633726655297}],""spent"":true,""tx_index"":6774039670699476,""type"":0,""value"":4133169668}}]","[{""type"":0,""spent"":true,""value"":3445212,""spending_outpoints"":[{""tx_index"":337634978484534,""n"":865}],""n"":0,""tx_index"":2642633726655297,""script"":""a914edca00cc0f777141459e6a4f9d1b7dbddbbf72e587"",""addr"":""3PNL4RteLRyM16Db6A1ZPTa2ie2GuKzEm2""},{""type"":0,""spent"":true,""value"":3458171,""spending_outpoints"":[{""tx_index"":7220154192244169,""n"":0}],""n"":1,""tx_index"":2642633726655297,""script"":""0014aed105670d14e95ac40041d0c8e602440256e5db"",""addr"":""bc1q4mgs2ecdzn5443qqg8gv3eszgsp9dewms0y9c5""},{""type"":0,""spent"":true,""value"":511350,""spending_outpoints"":[{""tx_index"":4536634227152657,""n"":136}],""n"":2,""tx_index"":2642633726655297,""script"":""a9141920b5a6d64049219f504a3ff4a9658aaa2e860587"",""addr"":""33yt13KParc8KDpTb5LWoiAJNPhSvbs3kV""},{""type"":0,""spent"":true,""value"":356814,""spending_outpoints"":[{""tx_index"":2532008642028203,""n"":78}],""n"":3,""tx_index"":2642633726655297,""script"":""76a91457edc652222e0810cdf2f4695699e1aa252f844388ac"",""addr"":""191vdZjcQtNnXp6jBe3j6z1eoUSnPZiKVp""},{""type"":0,""spent"":true,""value"":1528194,""spending_outpoints"":[{""tx_index"":2907492521783849,""n"":89}],""n"":4,""tx_index"":2642633726655297,""script"":""76a914b553e9d60d60936311c6316105fedab92f6d106188ac"",""addr"":""1HXmq8Rxq9eJ27CydcsakMFMfw35ZFFUd6""},{""type"":0,""spent"":true,""value"":81477,""spending_outpoints"":[{""tx_index"":3624352809475566,""n"":2}],""n"":5,""tx_index"":2642633726655297,""script"":""00143639d465b9a26721e77bae3fdf4984fc9497ead8"",""addr"":""bc1qxcuagede5fnjremm4cla7jvylj2f06kc2x7rry""},{""type"":0,""spent"":false,""value"":659894,""spending_outpoints"":[],""n"":6,""tx_index"":2642633726655297,""script"":""0014833b2f885e29ed257ce0f0366eee56364d48e592"",""addr"":""bc1qsvajlzz798kj2l8q7qmxamjkxex53evjlea4de""},{""type"":0,""spent"":true,""value"":696745,""spending_outpoints"":[{""tx_index"":1302727104809183,""n"":0}],""n"":7,""tx_index"":2642633726655297,""script"":""0014db44060640ff11838cacf70891de88b681261eda"",""addr"":""bc1qmdzqvpjqlugc8r9v7uyfrh5gk6qjv8k6mg7eyu""},{""type"":0,""spent"":false,""value"":1830,""spending_outpoints"":[],""n"":8,""tx_index"":2642633726655297,""script"":""76a914a0b0d60e5991578ed37cbda2b17d8b2ce23ab29588ac"",""addr"":""1FeexV6bAHb8ybZjqQMjJrcCrHGW9sb6uF""},{""type"":0,""spent"":true,""value"":99732,""spending_outpoints"":[{""tx_index"":8418980389782393,""n"":30}],""n"":9,""tx_index"":2642633726655297,""script"":""76a914164833d0991de809e1e86fee9b1972dc3594480488ac"",""addr"":""132pMw1BYU782URd4au1weWaFbgo1vYZHF""},{""type"":0,""spent"":true,""value"":5096621,""spending_outpoints"":[{""tx_index"":7497141914772913,""n"":3}],""n"":10,""tx_index"":2642633726655297,""script"":""0014a9d8a5a7d75e8309a88f142c0751189e9250e06f"",""addr"":""bc1q48v2tf7ht6psn2y0zskqw5gcn6f9pcr00p0n9z""},{""type"":0,""spent"":true,""value"":3457695,""spending_outpoints"":[{""tx_index"":4990730785933243,""n"":0}],""n"":11,""tx_index"":2642633726655297,""script"":""0014370fc67451f7bfd6681b0ce94dd76bc34c840f35"",""addr"":""bc1qxu8uvaz377lav6qmpn55m4mtcdxggre4uy9pvk""},{""type"":0,""spent"":true,""value"":82408,""spending_outpoints"":[{""tx_index"":3668190691409500,""n"":0}],""n"":12,""tx_index"":2642633726655297,""script"":""00145fd87d965593dff5df3d989b2a150d6fd9ac8afc"",""addr"":""bc1qtlv8m9j4j00ltheanzdj59gddlv6ezhuvpv48s""},{""type"":0,""spent"":false,""value"":17200000,""spending_outpoints"":[],""n"":13,""tx_index"":2642633726655297,""script"":""0014fb7c941d07c1cb163c81970afbe19472dbd61179"",""addr"":""bc1qld7fg8g8c893v0ypju90hcv5wtdavyte0csjzv""},{""type"":0,""spent"":true,""value"":34619,""spending_outpoints"":[{""tx_index"":8120278342956050,""n"":27}],""n"":14,""tx_index"":2642633726655297,""script"":""0014b9c1939a9dd2565aef2dc584c6ba75b213e061c2"",""addr"":""bc1qh8qe8x5a6ft94medckzvdwn4kgf7qcwzzz3tal""},{""type"":0,""spent"":true,""value"":363196,""spending_outpoints"":[{""tx_index"":3516044578722611,""n"":345}],""n"":15,""tx_index"":2642633726655297,""script"":""0014aa1744857602e12672a1b52b6691c78544f49c29"",""addr"":""bc1q4gt5fptkqtsjvu4pk54kdyw8s4z0f8pfcdfvhv""},{""type"":0,""spent"":true,""value"":1713463,""spending_outpoints"":[{""tx_index"":337634978484534,""n"":405}],""n"":16,""tx_index"":2642633726655297,""script"":""a914f343c5979b72a13c8a6f2c89d95d07e4410570c187"",""addr"":""3PsHK2dLcTNPzGk7Cq7MQAAWsazwwGLKri""},{""type"":0,""spent"":false,""value"":4020050,""spending_outpoints"":[],""n"":17,""tx_index"":2642633726655297,""script"":""0014e3e0b326c13105f1fcabb3c8f7980bd0091cf61d"",""addr"":""bc1qu0stxfkpxyzlrl9tk0y00xqt6qy3easae78nxc""},{""type"":0,""spent"":false,""value"":17268586,""spending_outpoints"":[],""n"":18,""tx_index"":2642633726655297,""script"":""0014c932290e8e6a788401cd7072bdb86cb6269096c5"",""addr"":""bc1qeyezjr5wdfuggqwdwpetmwrvkcnfp9k9c4yh4p""},{""type"":0,""spent"":true,""value"":850000,""spending_outpoints"":[{""tx_index"":5050731473598376,""n"":3}],""n"":19,""tx_index"":2642633726655297,""script"":""0014aee7ecbabaea64cdf40aa1a92354582bc83f9c9d"",""addr"":""bc1q4mn7ew46afjvmaq25x5jx4zc90yrl8yajf68lu""},{""type"":0,""spent"":true,""value"":4072167496,""spending_outpoints"":[{""tx_index"":6460489833802674,""n"":0}],""n"":20,""tx_index"":2642633726655297,""script"":""001408da93bfad48bddcdaf49e65248c3195a1838caa"",""addr"":""bc1qprdf80adfz7aekh5nejjfrp3jksc8r929svpxk""}]",1830,7995725271181
"bba904c76a975d78305574d7288369235412129907a9cb6b724e421af859d3b0",1,1,21,839,3026,79742,"0.0.0.0",0,6221497408637001,false,1682566881,787162,787162,"[{""sequence"":4294967295,""witness"":""02483045022100d1fdcc7009127300b406f51dbe5b9ca712fde70ee99a44b23a4634632f47af9902207cbb68d7ae92542584f7b2cb2bea0a800265bf50a86e3d7b4b200ed566187cf50121022a51bd8200f44d72e94fa623ad6f79efb10fa6a873b5a8cf1c63b47f6301729b"",""script"":"""",""index"":0,""prev_out"":{""addr"":""bc1qprdf80adfz7aekh5nejjfrp3jksc8r929svpxk"",""n"":18,""script"":""001408da93bfad48bddcdaf49e65248c3195a1838caa"",""spending_outpoints"":[{""n"":0,""tx_index"":6221497408637001}],""spent"":true,""tx_index"":6981845462590677,""type"":0,""value"":4176249267}}]","[{""type"":0,""spent"":true,""value"":207037,""spending_outpoints"":[{""tx_index"":4793605943120450,""n"":183}],""n"":0,""tx_index"":6221497408637001,""script"":""a91490efa5489b9eee9a9e60173aa3178650faf39b4487"",""addr"":""3EuNK3Aw9drdGmiRbKxXLwzQYedxUMvKm3""},{""type"":0,""spent"":true,""value"":1048503,""spending_outpoints"":[{""tx_index"":8811491508764025,""n"":0}],""n"":1,""tx_index"":6221497408637001,""script"":""76a914b3602c14055d07d1bf412a09e0576536553988f488ac"",""addr"":""1HMTAVsuii7aou9bVzX7viSsEwa4o3baYq""},{""type"":0,""spent"":true,""value"":364334,""spending_outpoints"":[{""tx_index"":8796320135093617,""n"":104}],""n"":2,""tx_index"":6221497408637001,""script"":""a9141a096d7df48e9ccde7d62358cbe6494ebdefd11a87"",""addr"":""344gnaaBNhDWk49GNmrWZuxSnciuQbHmHF""},{""type"":0,""spent"":true,""value"":80002,""spending_outpoints"":[{""tx_index"":7141749324393226,""n"":661}],""n"":3,""tx_index"":6221497408637001,""script"":""a91424dd1769395addf3555ef02832d189af9bf1258887"",""addr"":""353w79pU51tYzsS75YhSzrb1qXrZDmM96u""},{""type"":0,""spent"":true,""value"":8432316,""spending_outpoints"":[{""tx_index"":1434997070266604,""n"":51}],""n"":4,""tx_index"":6221497408637001,""script"":""a914314264072e0a16a4d73cbab18b66fc379efe360987"",""addr"":""36BUZrQEbQj16A3vjyT1H5PF1AiFjR4WuW""},{""type"":0,""spent"":true,""value"":54574,""spending_outpoints"":[{""tx_index"":8959823183108812,""n"":294}],""n"":5,""tx_index"":6221497408637001,""script"":""76a914599f74bcd583a8986f75c2582143942ef292037088ac"",""addr"":""19AtAGgqNJhCoSaPXVHaCpvSh2xsWKuLrP""},{""type"":0,""spent"":true,""value"":57024,""spending_outpoints"":[{""tx_index"":8055880148673716,""n"":457}],""n"":6,""tx_index"":6221497408637001,""script"":""a914e97505e0528534a805e1f5f8046b810c6a2eff9987"",""addr"":""3NyRZ8wGjAEAaecaSPPQmHwq4Q7BAmrqcV""},{""type"":0,""spent"":true,""value"":107053,""spending_outpoints"":[{""tx_index"":3855693002559832,""n"":0}],""n"":7,""tx_index"":6221497408637001,""script"":""76a914db67bf2f81ef1ff4fbe702d87ebc790e271f558688ac"",""addr"":""1M17GU3HEKCB7EbKde2PKFDCbFnS8v6CQu""},{""type"":0,""spent"":true,""value"":328140,""spending_outpoints"":[{""tx_index"":8822781887475708,""n"":24}],""n"":8,""tx_index"":6221497408637001,""script"":""0014a295afcc3a04de87f39e40132f118a826ec1fd39"",""addr"":""bc1q5226lnp6qn0g0uu7gqfj7yv2sfhvrlfevewz9j""},{""type"":0,""spent"":true,""value"":282100,""spending_outpoints"":[{""tx_index"":132470736500971,""n"":3}],""n"":9,""tx_index"":6221497408637001,""script"":""76a914a8e0ec9323d7a8bb11747762ca289181bbb6e1e888ac"",""addr"":""1GPwyEJZTGToncg853vZC5FXnHeNFXXDgb""},{""type"":0,""spent"":true,""value"":75863,""spending_outpoints"":[{""tx_index"":325103050833883,""n"":507}],""n"":10,""tx_index"":6221497408637001,""script"":""0014b3220f190e391858e60b43e1830cca6af0f09867"",""addr"":""bc1qkv3q7xgw8yv93estg0scxrx2dtc0pxr8m4cl08""},{""type"":0,""spent"":false,""value"":1830,""spending_outpoints"":[],""n"":11,""tx_index"":6221497408637001,""script"":""76a914a0b0d60e5991578ed37cbda2b17d8b2ce23ab29588ac"",""addr"":""1FeexV6bAHb8ybZjqQMjJrcCrHGW9sb6uF""},{""type"":0,""spent"":false,""value"":11401510,""spending_outpoints"":[],""n"":12,""tx_index"":6221497408637001,""script"":""00140c3f2cc334b02d64499435ea6d701a835deb5faf"",""addr"":""bc1qpsljese5kqkkgjv5xh4x6uq6sdw7kha0stkck0""},{""type"":0,""spent"":true,""value"":10047768,""spending_outpoints"":[{""tx_index"":8300085593297369,""n"":158}],""n"":13,""tx_index"":6221497408637001,""script"":""76a9149edcb994cf9558824b7e7d2eccc15ff70261a6d388ac"",""addr"":""1FUzBYfiSqWn6rtVgdrmaKVVxJoUa4qMue""},{""type"":0,""spent"":true,""value"":1726143,""spending_outpoints"":[{""tx_index"":4146964804592159,""n"":53}],""n"":14,""tx_index"":6221497408637001,""script"":""0014d068dd78c1dec789a6f7102578e65f5ccaecafab"",""addr"":""bc1q6p5d67xpmmrcnfhhzqjh3ejltn9wetatsy5ck6""},{""type"":0,""spent"":true,""value"":178234,""spending_outpoints"":[{""tx_index"":3588553285712134,""n"":0}],""n"":15,""tx_index"":6221497408637001,""script"":""001460af3ad4a9773ce1cd72e91d39fe966e0fffc880"",""addr"":""bc1qvzhn449fwu7wrntjaywnnl5kdc8lljyqzl4tk7""},{""type"":0,""spent"":true,""value"":1036486,""spending_outpoints"":[{""tx_index"":820222121927929,""n"":3}],""n"":16,""tx_index"":6221497408637001,""script"":""a914515f47de7b5afe2987ffe1f16b4b4e1ae3178a7687"",""addr"":""397GoJaDH4ipwvWZhNRQ3UhdxQbsQeR5C1""},{""type"":0,""spent"":true,""value"":305990,""spending_outpoints"":[{""tx_index"":8815987426307172,""n"":70}],""n"":17,""tx_index"":6221497408637001,""script"":""a914ec83cb7ed63d29e23c3200b6ed21cf77ed8070ca87"",""addr"":""3PFbH5xG8bSnwfnHJfPF8nf9KBwNdCgrnL""},{""type"":0,""spent"":true,""value"":183383,""spending_outpoints"":[{""tx_index"":7090769619559010,""n"":187}],""n"":18,""tx_index"":6221497408637001,""script"":""a9140c8b5364d3afbc3395d2755ee15835fcf38bf0ce87"",""addr"":""32qLwNMiS7T5pa5iPc5B83rrsM7j91cWrB""},{""type"":0,""spent"":true,""value"":15960,""spending_outpoints"":[{""tx_index"":2833101293216699,""n"":0}],""n"":19,""tx_index"":6221497408637001,""script"":""a914fb45a00eaf57cd8ab39380d9dd3f551a500ad94387"",""addr"":""3QbcwLbCEBidfGno7xVGJ2SLGCaVt66JJm""},{""type"":0,""spent"":true,""value"":4140235275,""spending_outpoints"":[{""tx_index"":6774039670699476,""n"":0}],""n"":20,""tx_index"":6221497408637001,""script"":""001408da93bfad48bddcdaf49e65248c3195a1838caa"",""addr"":""bc1qprdf80adfz7aekh5nejjfrp3jksc8r929svpxk""}]",1830,7995725269351
"7e6532ec27d54a3be18bee9ae31b1557c3e371f7647ab85328d7cd142bfdf40a",1,1,20,817,2941,75762,"0.0.0.0",0,385514744224186,false,1682564833,787161,787161,"[{""sequence"":4294967295,""witness"":""02473044022038218fdd30b3124d73056084160f76a385b1f9f90c72953db93bb9194ca0dc6302201f15f26d446f827009df9121f121e85ded3705d687795ecb7998d054b2c0b0390121022a51bd8200f44d72e94fa623ad6f79efb10fa6a873b5a8cf1c63b47f6301729b"",""script"":"""",""index"":0,""prev_out"":{""addr"":""bc1qprdf80adfz7aekh5nejjfrp3jksc8r929svpxk"",""n"":18,""script"":""001408da93bfad48bddcdaf49e65248c3195a1838caa"",""spending_outpoints"":[{""n"":0,""tx_index"":385514744224186}],""spent"":true,""tx_index"":8352155716695648,""type"":0,""value"":4218183941}}]","[{""type"":0,""spent"":true,""value"":103609,""spending_outpoints"":[{""tx_index"":3141557559373262,""n"":0}],""n"":0,""tx_index"":385514744224186,""script"":""00146c368871d19d06f6564eaa8dd0622b0beff947c9"",""addr"":""bc1qdsmgsuw3n5r0v4jw42xaqc3tp0hlj37f3qda5g""},{""type"":0,""spent"":true,""value"":174253,""spending_outpoints"":[{""tx_index"":3648848494401746,""n"":25}],""n"":1,""tx_index"":385514744224186,""script"":""0014d0ad12458421f875d0e910faff99fc121581a054"",""addr"":""bc1q6zk3y3vyy8u8t58fzra0lx0uzg2crgz5kc8hk0""},{""type"":0,""spent"":true,""value"":329983,""spending_outpoints"":[{""tx_index"":221764711038142,""n"":488}],""n"":2,""tx_index"":385514744224186,""script"":""a91446b300b6c163235b2fee51f81012f1b3eb75073787"",""addr"":""388qfJZptB3YodnAcNhjrT2GTbknzBVccB""},{""type"":0,""spent"":true,""value"":126711,""spending_outpoints"":[{""tx_index"":947683040465382,""n"":31}],""n"":3,""tx_index"":385514744224186,""script"":""a914d1654267349aa060bb4bc435f9db8a2a6ee45f2a87"",""addr"":""3LnCTG9EE7g4fPbzCZr16FWqrvqh9EdzMj""},{""type"":0,""spent"":false,""value"":1830,""spending_outpoints"":[],""n"":4,""tx_index"":385514744224186,""script"":""76a914a0b0d60e5991578ed37cbda2b17d8b2ce23ab29588ac"",""addr"":""1FeexV6bAHb8ybZjqQMjJrcCrHGW9sb6uF""},{""type"":0,""spent"":true,""value"":1085236,""spending_outpoints"":[{""tx_index"":6573351209967006,""n"":3}],""n"":5,""tx_index"":385514744224186,""script"":""76a9148f85a840f8011f8bea97598c5c1e6802b42b107688ac"",""addr"":""1E5sk6nLiN2sNAHbR1kJPHF4UDv5oRfwr4""},{""type"":0,""spent"":true,""value"":71510,""spending_outpoints"":[{""tx_index"":4402613849251399,""n"":668}],""n"":6,""tx_index"":385514744224186,""script"":""a914c4b45cada7354a6a5256f2d17b1459f13e25b70c87"",""addr"":""3Kd6Rv4e4WBf1MZ1Cyr1VfYmw5zhpXfdh4""},{""type"":0,""spent"":true,""value"":427513,""spending_outpoints"":[{""tx_index"":230106033582555,""n"":496}],""n"":7,""tx_index"":385514744224186,""script"":""a9141ddc9c8ee462b67cccf3a0dd1ecd838fdeee87d687"",""addr"":""34QuoU1K6PmYFx6P5e66Ex5WRfqokZ4FWm""},{""type"":0,""spent"":true,""value"":60126,""spending_outpoints"":[{""tx_index"":7525257852062376,""n"":582}],""n"":8,""tx_index"":385514744224186,""script"":""a914fa61bb619ce5851079bac2e0df701c89aa54bcf887"",""addr"":""3QWuw36FecWjzi3a6UbwW9EJbUt9RSWsFJ""},{""type"":0,""spent"":true,""value"":149764,""spending_outpoints"":[{""tx_index"":1777397974653673,""n"":79}],""n"":9,""tx_index"":385514744224186,""script"":""002010194eb1fb3eed3f07d21bea9e072b32c10eb024d8d8789543d1cb7ab11fa3d7"",""addr"":""bc1qzqv5av0m8mkn7p7jr04fupetxtqsavpymrv8392r689h4vgl50tsyz70pz""},{""type"":0,""spent"":true,""value"":103522,""spending_outpoints"":[{""tx_index"":3824417407201073,""n"":82}],""n"":10,""tx_index"":385514744224186,""script"":""a91496f662e5cca06d065dcd71432924fb6f10a56a6787"",""addr"":""3FTESYGQNDfUQj4bzBGriEnBMDRJvvEcYX""},{""type"":0,""spent"":true,""value"":78817,""spending_outpoints"":[{""tx_index"":8838678627063100,""n"":43}],""n"":11,""tx_index"":385514744224186,""script"":""76a914c03edf82317a3c513153a63ede2cdbfda0a158d388ac"",""addr"":""1JXW4L7wD46997FjCGN4X3fxV6b5eQUt1b""},{""type"":0,""spent"":true,""value"":254359,""spending_outpoints"":[{""tx_index"":4854629733725471,""n"":0}],""n"":12,""tx_index"":385514744224186,""script"":""00147cda380a654fa1382fcfd90b31467ee2012fd1c5"",""addr"":""bc1q0ndrszn9f7snst70my9nz3n7ugqjl5w9as6al6""},{""type"":0,""spent"":true,""value"":345250,""spending_outpoints"":[{""tx_index"":2530089586638426,""n"":24}],""n"":13,""tx_index"":385514744224186,""script"":""76a914fecb9c7e2f59f19d1665910b9194d320adfe0d2588ac"",""addr"":""1QEEYtPq8PpoRXruAYCvBjbGWXwLw968xo""},{""type"":0,""spent"":true,""value"":302303,""spending_outpoints"":[{""tx_index"":221764711038142,""n"":57}],""n"":14,""tx_index"":385514744224186,""script"":""a9141511fa492b6e23577dd375dcdd36f0296f7c1e4e87"",""addr"":""33cRegadMgt9XxhyksUWqFS9GAjGMYwZau""},{""type"":0,""spent"":true,""value"":236392,""spending_outpoints"":[{""tx_index"":8076510734588944,""n"":1}],""n"":15,""tx_index"":385514744224186,""script"":""76a914e865cec5f00a11092db5b0444cb5716fc8adbaf988ac"",""addr"":""1NBojEEgabugasLN89LZi3osnFScgMryRc""},{""type"":0,""spent"":true,""value"":68639,""spending_outpoints"":[{""tx_index"":883412663803236,""n"":0}],""n"":16,""tx_index"":385514744224186,""script"":""a914bac6bad1dbd86e74100f072f4995dbf40b449b9c87"",""addr"":""3JibgD9p7jGuzAiwTEbeqXkr174o5nHMat""},{""type"":0,""spent"":true,""value"":69002,""spending_outpoints"":[{""tx_index"":6620372151802828,""n"":27}],""n"":17,""tx_index"":385514744224186,""script"":""a9143e22624dcef3f260c3710ad9a3b90f49809309c887"",""addr"":""37MZ1Um3RkGmBz89bc6JbrC5vgYP8FV95J""},{""type"":0,""spent"":true,""value"":339938,""spending_outpoints"":[{""tx_index"":630982020525869,""n"":123}],""n"":18,""tx_index"":385514744224186,""script"":""a914dc6da803499b854133f76d7033c001ded21b385887"",""addr"":""3MnXwoLcxr9gHzDxk9Av8XpfjaKqJZLxaD""},{""type"":0,""spent"":true,""value"":4213779422,""spending_outpoints"":[{""tx_index"":6981845462590677,""n"":0}],""n"":19,""tx_index"":385514744224186,""script"":""001408da93bfad48bddcdaf49e65248c3195a1838caa"",""addr"":""bc1qprdf80adfz7aekh5nejjfrp3jksc8r929svpxk""}]",1830,7995725267521
"f29c70a3ecf83fb33d89207410b18aa1684155d38914f0e6f5cab08482102304",1,1,21,840,3030,79738,"0.0.0.0",0,145556715378201,false,1682564837,787161,787161,"[{""sequence"":4294967295,""witness"":""02483045022100ab47b31520479c151203ed690a7f0b98707b67134c78e26cb8b72a3c3d75a2e702201df096100689a51efc5a8824283f3ff6ec8c2ffdef7e6bd812d20dc43d2e676e0121022a51bd8200f44d72e94fa623ad6f79efb10fa6a873b5a8cf1c63b47f6301729b"",""script"":"""",""index"":0,""prev_out"":{""addr"":""bc1qprdf80adfz7aekh5nejjfrp3jksc8r929svpxk"",""n"":20,""script"":""001408da93bfad48bddcdaf49e65248c3195a1838caa"",""spending_outpoints"":[{""n"":0,""tx_index"":145556715378201}],""spent"":true,""tx_index"":7447034100070467,""type"":0,""value"":11218154148}}]","[{""type"":0,""spent"":true,""value"":287255,""spending_outpoints"":[{""tx_index"":24288332608397,""n"":976}],""n"":0,""tx_index"":145556715378201,""script"":""a9146289602a4d6433ae67400b6389f3047b2f5fe5a887"",""addr"":""3Ag2iNS1Fxew9y4b8bd6G8qyE25gJFnLba""},{""type"":0,""spent"":true,""value"":6881307,""spending_outpoints"":[{""tx_index"":2843297419005435,""n"":0}],""n"":1,""tx_index"":145556715378201,""script"":""0014884867aadc0c9dd2e017031af98464fac4a36d57"",""addr"":""bc1q3pyx02kupjwa9cqhqvd0npryltz2xm2h8h8kqv""},{""type"":0,""spent"":true,""value"":41291,""spending_outpoints"":[{""tx_index"":4020051040529209,""n"":5}],""n"":2,""tx_index"":145556715378201,""script"":""76a9141864de5c3406d6913cea1226a8c6e1763bb87a1388ac"",""addr"":""13Dz45T9CYk3VempwV8fdTtTMxfveJZkHF""},{""type"":0,""spent"":true,""value"":3450,""spending_outpoints"":[{""tx_index"":8292320659700143,""n"":1}],""n"":3,""tx_index"":145556715378201,""script"":""a914bac6bad1dbd86e74100f072f4995dbf40b449b9c87"",""addr"":""3JibgD9p7jGuzAiwTEbeqXkr174o5nHMat""},{""type"":0,""spent"":false,""value"":708065,""spending_outpoints"":[],""n"":4,""tx_index"":145556715378201,""script"":""a91486d913517bf015ec10b7792a6132018140c15b6587"",""addr"":""3Dz2Wv7YGRBHMxXS3tFLR8HNun6P86hHZ8""},{""type"":0,""spent"":true,""value"":145421,""spending_outpoints"":[{""tx_index"":2617690442806851,""n"":460}],""n"":5,""tx_index"":145556715378201,""script"":""00145043f1a3048ab8be1b8297df3ff41027dec56964"",""addr"":""bc1q2pplrgcy32utuxuzjl0nlaqsyl0v26tydpz25p""},{""type"":0,""spent"":true,""value"":68370,""spending_outpoints"":[{""tx_index"":3378903298476847,""n"":25}],""n"":6,""tx_index"":145556715378201,""script"":""76a9144767cf863635b3c569002ae2417747f0444dd84888ac"",""addr"":""17WZLWZwg8HxGD9Ut1GoMCa7QHHThay2Zu""},{""type"":0,""spent"":true,""value"":741658,""spending_outpoints"":[{""tx_index"":7068465604403255,""n"":1}],""n"":7,""tx_index"":145556715378201,""script"":""0014976d95ce348d351fb2f48ed8bb30d0b0edf82dd0"",""addr"":""bc1qjaketn353563lvh53mvtkvxskrklstwsw7prkf""},{""type"":0,""spent"":true,""value"":51336,""spending_outpoints"":[{""tx_index"":3548368616127306,""n"":10}],""n"":8,""tx_index"":145556715378201,""script"":""a9141c4eb48016a1dcd4d1ebcbf1aacbca718d6a65b387"",""addr"":""34Gh8STjM7vd9QVvym9w7SvV9PKJMTaVi4""},{""type"":0,""spent"":true,""value"":47571,""spending_outpoints"":[{""tx_index"":5629028107401729,""n"":5}],""n"":9,""tx_index"":145556715378201,""script"":""0014d246d1caedddcee734660737f0dacfc42d596450"",""addr"":""bc1q6frdrjhdmh8wwdrxqumlpkk0csk4jezswnmlxw""},{""type"":0,""spent"":false,""value"":8635650,""spending_outpoints"":[],""n"":10,""tx_index"":145556715378201,""script"":""76a9145f5be13aa868a7e62351e4aa3dd08cd634588f7488ac"",""addr"":""19hDG9NmVyhdvz9KyMd8DsA6TFwrYrrhmJ""},{""type"":0,""spent"":true,""value"":516070,""spending_outpoints"":[{""tx_index"":5394257232315434,""n"":262}],""n"":11,""tx_index"":145556715378201,""script"":""a914ed71028efc3ac1a2ca4b54607d2468ca843a4a5b87"",""addr"":""3PLVT5a6sjx4WrjLrJ2MnS15c5QxCgBodq""},{""type"":0,""spent"":true,""value"":68971,""spending_outpoints"":[{""tx_index"":6961767544188972,""n"":11}],""n"":12,""tx_index"":145556715378201,""script"":""76a914a8270376e8ad24c120750dce5e60c3c36a0c2a5f88ac"",""addr"":""1GL7FwFQPRAjMgCscgSnGjVpLn93FxLbkE""},{""type"":0,""spent"":false,""value"":96480,""spending_outpoints"":[],""n"":13,""tx_index"":145556715378201,""script"":""76a914d960eb4bf3e4c139258d60fdd2d12c51bad46c8488ac"",""addr"":""1LpPjgoYVUj3Thw24i6htUFFfnh6ztRZvp""},{""type"":0,""spent"":true,""value"":86269,""spending_outpoints"":[{""tx_index"":5344638767897911,""n"":0}],""n"":14,""tx_index"":145556715378201,""script"":""a914ae57d87b1271d1294c1802dba0cfbe110bf36acb87"",""addr"":""3HarjYUWxAYsgJEmVjRCHtWH97EcRJnpnH""},{""type"":0,""spent"":true,""value"":517860,""spending_outpoints"":[{""tx_index"":2143541183488760,""n"":159}],""n"":15,""tx_index"":145556715378201,""script"":""a9149d355b49760465b697c976fad343bb045627c7c287"",""addr"":""3G2Fvwb3y4EGYDRNRRWVJsnWxwSdXj5vL3""},{""type"":0,""spent"":false,""value"":2222,""spending_outpoints"":[],""n"":16,""tx_index"":145556715378201,""script"":""76a914a0b0d60e5991578ed37cbda2b17d8b2ce23ab29588ac"",""addr"":""1FeexV6bAHb8ybZjqQMjJrcCrHGW9sb6uF""},{""type"":0,""spent"":true,""value"":355337,""spending_outpoints"":[{""tx_index"":1928693434331092,""n"":1}],""n"":17,""tx_index"":145556715378201,""script"":""0014a3ad4494bc07b6f9922969f5b60379ee15f09879"",""addr"":""bc1q5wk5f99uq7m0ny3fd86mvqmeac2lpxre4qc2dc""},{""type"":0,""spent"":true,""value"":100072,""spending_outpoints"":[{""tx_index"":947683040465382,""n"":37}],""n"":18,""tx_index"":145556715378201,""script"":""00144ada3b0c2723ab961ccf50fc2655c4a143a71560"",""addr"":""bc1qftdrkrp8yw4ev8x02r7zv4wy59p6w9tq3h7ld6""},{""type"":0,""spent"":true,""value"":153534,""spending_outpoints"":[{""tx_index"":1938629256427716,""n"":37}],""n"":19,""tx_index"":145556715378201,""script"":""76a914b61946c709dc6471fb617bb3fdd6bfcde0e903d888ac"",""addr"":""1HbrG9tyCtW8ZL2btwZVJqVHyT7vtwmHDz""},{""type"":0,""spent"":true,""value"":11198566221,""spending_outpoints"":[{""tx_index"":1768391301341694,""n"":0}],""n"":20,""tx_index"":145556715378201,""script"":""001408da93bfad48bddcdaf49e65248c3195a1838caa"",""addr"":""bc1qprdf80adfz7aekh5nejjfrp3jksc8r929svpxk""}]",2222,7995725265691
"860c7652f8259edd800d58cc7ebfc7b58bab20c97c736ab88b04b3d154ee61ed",1,1,19,776,2774,71750,"0.0.0.0",0,8352155716695648,false,1682564349,787160,787160,"[{""sequence"":4294967295,""witness"":""02483045022100c0c649713f970a77a47638571b9fe2aa02e9fff42f96bb0d41a1bda371bd5459022006504ba60951c7f25f25e717b11cd55b047d95746bff65538da60e268568820e0121022a51bd8200f44d72e94fa623ad6f79efb10fa6a873b5a8cf1c63b47f6301729b"",""script"":"""",""index"":0,""prev_out"":{""addr"":""bc1qprdf80adfz7aekh5nejjfrp3jksc8r929svpxk"",""n"":18,""script"":""001408da93bfad48bddcdaf49e65248c3195a1838caa"",""spending_outpoints"":[{""n"":0,""tx_index"":8352155716695648}],""spent"":true,""tx_index"":3653881703829884,""type"":0,""value"":4267901310}}]","[{""type"":0,""spent"":true,""value"":652848,""spending_outpoints"":[{""tx_index"":3711664433571442,""n"":2}],""n"":0,""tx_index"":8352155716695648,""script"":""76a91456eaae561aee6c5040e73b8df1e9e1f7c064861b88ac"",""addr"":""18vaFRKNEACnKtFkABZvMdDReGuthkwnS4""},{""type"":0,""spent"":true,""value"":3467220,""spending_outpoints"":[{""tx_index"":337634978484534,""n"":888}],""n"":1,""tx_index"":8352155716695648,""script"":""a914799ef33300169e54f9aecb91a101cec608578ec387"",""addr"":""3Cn66o3R44yF4ySLVfKR8SGBK6FNFTZrLH""},{""type"":0,""spent"":true,""value"":515505,""spending_outpoints"":[{""tx_index"":5394257232315434,""n"":159}],""n"":2,""tx_index"":8352155716695648,""script"":""a914bcb523a62434cc95cffaf72c5234758fb34a12b787"",""addr"":""3JtoxPDcFPVX5ywyiN8mVbmXLnWxkt45X2""},{""type"":0,""spent"":true,""value"":191740,""spending_outpoints"":[{""tx_index"":274782578368193,""n"":168}],""n"":3,""tx_index"":8352155716695648,""script"":""a914f43704c5e844407ba7b6e154e96fe4455237d87487"",""addr"":""3PxJi7VqMdmQgPbdBxgB3ox1H7SXT9Lxqw""},{""type"":0,""spent"":false,""value"":17320000,""spending_outpoints"":[],""n"":4,""tx_index"":8352155716695648,""script"":""00140f3fbbf0ab5f0bab9a4d4fe250e68a908369d7e9"",""addr"":""bc1qpulmhu9ttu96hxjdfl39pe52jzpkn4lfp4x4uz""},{""type"":0,""spent"":true,""value"":64641,""spending_outpoints"":[{""tx_index"":4460831258739229,""n"":569}],""n"":5,""tx_index"":8352155716695648,""script"":""a914cebf7e145735376ac6072ed2d826b44c1dbc17a987"",""addr"":""3LYCXC8vYqwKC9enRaK5baBDVM69N9Xfck""},{""type"":0,""spent"":true,""value"":34622,""spending_outpoints"":[{""tx_index"":8959823183108812,""n"":282}],""n"":6,""tx_index"":8352155716695648,""script"":""76a914988fc0a9174457d1d356776d6e0c33af55a6fdd288ac"",""addr"":""1EufvGENDso5wwW2yKDu82DxtsA9sswPGL""},{""type"":0,""spent"":false,""value"":1830,""spending_outpoints"":[],""n"":7,""tx_index"":8352155716695648,""script"":""76a914a0b0d60e5991578ed37cbda2b17d8b2ce23ab29588ac"",""addr"":""1FeexV6bAHb8ybZjqQMjJrcCrHGW9sb6uF""},{""type"":0,""spent"":false,""value"":16911617,""spending_outpoints"":[],""n"":8,""tx_index"":8352155716695648,""script"":""00140621438c20f5a1328b980b9d45a16e5cbeba865f"",""addr"":""bc1qqcs58rpq7ksn9zucpww5tgtwtjlt4pjlxvdzhk""},{""type"":0,""spent"":true,""value"":8709254,""spending_outpoints"":[{""tx_index"":293498438317146,""n"":2}],""n"":9,""tx_index"":8352155716695648,""script"":""a9146ec299ccf4245b36de20003f796788bf8cff071187"",""addr"":""3BnfNk937e6Vwkdos4bZ3ZoR6tne1KyAJT""},{""type"":0,""spent"":true,""value"":116742,""spending_outpoints"":[{""tx_index"":6063712089940365,""n"":44}],""n"":10,""tx_index"":8352155716695648,""script"":""76a914f192695d15c5b9f9226c42cee68dd472ab9faaa088ac"",""addr"":""1P2KF5ygpmvvcH8nfwSYsvLQyB9q9BFMvu""},{""type"":0,""spent"":true,""value"":339178,""spending_outpoints"":[{""tx_index"":1257107318995592,""n"":327}],""n"":11,""tx_index"":8352155716695648,""script"":""a914792640710511e7fda815646656e18448cbeb5ee787"",""addr"":""3CjbWXniwbQT9ZinMGEAVqcNAgvaBxQ7fX""},{""type"":0,""spent"":true,""value"":40000,""spending_outpoints"":[{""tx_index"":1660579107004319,""n"":6}],""n"":12,""tx_index"":8352155716695648,""script"":""a91455dce2b22f4290349b4644f5fcf519b950970dd487"",""addr"":""39X1yFAq5ShRXVhzBjDU9sogSvEofPBryP""},{""type"":0,""spent"":true,""value"":203277,""spending_outpoints"":[{""tx_index"":1348669778179950,""n"":491}],""n"":13,""tx_index"":8352155716695648,""script"":""a914e5fe0ee061dd8cf2720e155f251278a04aa2be8987"",""addr"":""3Nf71jsUP52D6gbPfh3AN7eDga8cF7aUbv""},{""type"":0,""spent"":true,""value"":265055,""spending_outpoints"":[{""tx_index"":1360617411886326,""n"":374}],""n"":14,""tx_index"":8352155716695648,""script"":""a9141ca1fbac1e9e2bbe1acc9b81f732405a1f79d36087"",""addr"":""34JQthRXMTjNBM229Xnmux22BU151XjkKG""},{""type"":0,""spent"":true,""value"":682142,""spending_outpoints"":[{""tx_index"":1686114585174642,""n"":5}],""n"":15,""tx_index"":8352155716695648,""script"":""76a914aee04db0d898e7b6fe2e99e03e8b4c65faeb5e8388ac"",""addr"":""1GwfHFwBHaVmcDkcYUmHPechhMTNbrjZZx""},{""type"":0,""spent"":true,""value"":65325,""spending_outpoints"":[{""tx_index"":7525257852062376,""n"":961}],""n"":16,""tx_index"":8352155716695648,""script"":""a91432b55676d94efd935cc842bba15dd80a3cb3728d87"",""addr"":""36K8whjUg4393pKPZ18cKpDiniijuMwALM""},{""type"":0,""spent"":true,""value"":64623,""spending_outpoints"":[{""tx_index"":7525257852062376,""n"":924}],""n"":17,""tx_index"":8352155716695648,""script"":""a914be4784c6d1ddf1d8db68d2e6cc2d66daffef5b5787"",""addr"":""3K37zCGS6MPbydshbFfue5Ezg6rADw9sfJ""},{""type"":0,""spent"":true,""value"":4218183941,""spending_outpoints"":[{""tx_index"":385514744224186,""n"":0}],""n"":18,""tx_index"":8352155716695648,""script"":""001408da93bfad48bddcdaf49e65248c3195a1838caa"",""addr"":""bc1qprdf80adfz7aekh5nejjfrp3jksc8r929svpxk""}]",1830,7995725263469
"3ce8ae987849b49b73ed80e9e1e619e72a5d6820b59416c2e85efb84358f7e77",1,1,2,226,574,3312,"0.0.0.0",0,4204334471487339,false,1682522585,787137,787137,"[{""sequence"":4294967293,""witness"":""024830450221009dd61e774b8acb4810ebe3bb32703e5bfe543b3c42095caf214001259140bf6f02204aa7072811fa627d6729a3d46ac0d1ac71f3187e91bdb14b7b0f362c5bf3e44f0121021aa757df8106cf6033fcd08afb9f95d6a50f9e434ac400d4de5771d762f3387a"",""script"":"""",""index"":0,""prev_out"":{""addr"":""bc1q4pnhxhkr7uq3jzevaytg024hqdaurhze5dvrc5"",""n"":1,""script"":""0014a867735ec3f701190b2ce91687aab7037bc1dc59"",""spending_outpoints"":[{""n"":0,""tx_index"":4204334471487339}],""spent"":true,""tx_index"":3836173017145888,""type"":0,""value"":1140247}}]","[{""type"":0,""spent"":false,""value"":666,""spending_outpoints"":[],""n"":0,""tx_index"":4204334471487339,""script"":""76a914a0b0d60e5991578ed37cbda2b17d8b2ce23ab29588ac"",""addr"":""1FeexV6bAHb8ybZjqQMjJrcCrHGW9sb6uF""},{""type"":0,""spent"":true,""value"":1136269,""spending_outpoints"":[{""tx_index"":2091607717286083,""n"":1}],""n"":1,""tx_index"":4204334471487339,""script"":""00149ace1362160a22fd8eec717c68b4f6325eb5d197"",""addr"":""bc1qnt8pxcskpg30mrhvw97x3d8kxf0tt5vhg6hdl5""}]",666,7995725261639
"fc57f01e8afa6469b8d7576194ee7d18c8bcc346c7fab32fb92770813c6c61e4",1,1,19,768,2745,71657,"0.0.0.0",0,8035426523688452,false,1682547575,787134,787134,"[{""sequence"":4294967295,""witness"":""02473044022043e645fd1d56c8de39f911eed5b0a666f332a82601384fa1538f35cd033d19fc022025e7b15c4adb89ba9dcfb08ebabb8f225672c4707d3a288a148fba8ae3ab63410121022a51bd8200f44d72e94fa623ad6f79efb10fa6a873b5a8cf1c63b47f6301729b"",""script"":"""",""index"":0,""prev_out"":{""addr"":""bc1qprdf80adfz7aekh5nejjfrp3jksc8r929svpxk"",""n"":2,""script"":""001408da93bfad48bddcdaf49e65248c3195a1838caa"",""spending_outpoints"":[{""n"":0,""tx_index"":8035426523688452}],""spent"":true,""tx_index"":8274480452759029,""type"":0,""value"":4865430143}}]","[{""type"":0,""spent"":true,""value"":94637,""spending_outpoints"":[{""tx_index"":2399035180449540,""n"":6}],""n"":0,""tx_index"":8035426523688452,""script"":""76a91497601471e612959f54a085f1d97d8e4a090f12ee88ac"",""addr"":""1EoQ8iKCJnbC4EuPy6HZGvrKKPw8n4wXwu""},{""type"":0,""spent"":true,""value"":351976,""spending_outpoints"":[{""tx_index"":3081973050861266,""n"":33}],""n"":1,""tx_index"":8035426523688452,""script"":""76a9144ed9aef378b6e8c76ce3d591cb5dab18eb607c3e88ac"",""addr"":""18BvUsWB7heZ3pFjFYm3ov5Yw7kS6pcpDt""},{""type"":0,""spent"":true,""value"":1757295,""spending_outpoints"":[{""tx_index"":694324410842912,""n"":3}],""n"":2,""tx_index"":8035426523688452,""script"":""76a91432070fe5f8c3efa8f2dd660e16d5b80960f32b6888ac"",""addr"":""15ZXFGxCNs2qJRKwGbMKqN1RidqXK5KLTv""},{""type"":0,""spent"":true,""value"":1078188,""spending_outpoints"":[{""tx_index"":6573351209967006,""n"":6}],""n"":3,""tx_index"":8035426523688452,""script"":""76a9144be34cfce37d8085248be6228ae754d2d2a26dd088ac"",""addr"":""17vFyX7Nj17o3B27sCu2SarQsUd28sP8pv""},{""type"":0,""spent"":false,""value"":895415,""spending_outpoints"":[],""n"":4,""tx_index"":8035426523688452,""script"":""0014ada41d5a00a76c1166da0d675796a37f6744da3b"",""addr"":""bc1q4kjp6ksq5akpzek6p4n4094r0an5fk3m9hjvqy""},{""type"":0,""spent"":true,""value"":243336,""spending_outpoints"":[{""tx_index"":1849990537191508,""n"":114}],""n"":5,""tx_index"":8035426523688452,""script"":""001454e6490b8b4020daeaec5c3b27ccdbd90c26200e"",""addr"":""bc1q2nnyjzutgqsd46hvtsaj0nxmmyxzvgqwl0xney""},{""type"":0,""spent"":true,""value"":11345,""spending_outpoints"":[{""tx_index"":776952081229467,""n"":25}],""n"":6,""tx_index"":8035426523688452,""script"":""0014c83d27fd25b445a3a906d0abf79aee809a26c0c9"",""addr"":""bc1qeq7j0lf9k3z682gx6z4l0xhwszdzdsxf4a7ddt""},{""type"":0,""spent"":true,""value"":1462918,""spending_outpoints"":[{""tx_index"":5668083220585424,""n"":0}],""n"":7,""tx_index"":8035426523688452,""script"":""0014f5072aab5a51b86ecd4f4cb2ef6db53f5407fac0"",""addr"":""bc1q75rj42662xuxan20fjew7md48a2q07kqpauxqr""},{""type"":0,""spent"":true,""value"":353561,""spending_outpoints"":[{""tx_index"":6533173079545985,""n"":7}],""n"":8,""tx_index"":8035426523688452,""script"":""0014c84190d8f0ea6c080d9042368f8668774d7e7a2b"",""addr"":""bc1qepqepk8safkqsrvsggmglpngwaxhu73tzs96t4""},{""type"":0,""spent"":true,""value"":35397,""spending_outpoints"":[{""tx_index"":588010065873245,""n"":74}],""n"":9,""tx_index"":8035426523688452,""script"":""a914f213e48e7561840ee35947cd7707889723a0e30587"",""addr"":""3Pm1H9DyGmLWyon8qfMXy58kLXzRHQbQeM""},{""type"":0,""spent"":true,""value"":506530,""spending_outpoints"":[{""tx_index"":532905314002046,""n"":159}],""n"":10,""tx_index"":8035426523688452,""script"":""a91488530c3f855b1b623f321ba84fe9077c8ac2947a87"",""addr"":""3E7qJu3MiF6uCsjR8tFcsqhLPXSwkQtBgT""},{""type"":0,""spent"":true,""value"":556523,""spending_outpoints"":[{""tx_index"":3994752172893800,""n"":2}],""n"":11,""tx_index"":8035426523688452,""script"":""0014fcb272bce5d4aa977cb6481273779528ffd90ca2"",""addr"":""bc1qlje890896j4fwl9kfqf8xau49rlajr9zhfn0wc""},{""type"":0,""spent"":true,""value"":2315751,""spending_outpoints"":[{""tx_index"":7673779583480255,""n"":7}],""n"":12,""tx_index"":8035426523688452,""script"":""0014d66dfd079fd78b88f5417585bcdbe6958edd07d7"",""addr"":""bc1q6ekl6pul679c3a2pwkzmeklxjk8d6p7hqlpdrz""},{""type"":0,""spent"":true,""value"":6582096,""spending_outpoints"":[{""tx_index"":3524695515931963,""n"":3}],""n"":13,""tx_index"":8035426523688452,""script"":""0014642488d8364592557da829529deef70384e0988f"",""addr"":""bc1qvsjg3kpkgkf92ldg99ffmmhhqwzwpxy0s0zkwa""},{""type"":0,""spent"":false,""value"":1969,""spending_outpoints"":[],""n"":14,""tx_index"":8035426523688452,""script"":""76a914a0b0d60e5991578ed37cbda2b17d8b2ce23ab29588ac"",""addr"":""1FeexV6bAHb8ybZjqQMjJrcCrHGW9sb6uF""},{""type"":0,""spent"":true,""value"":179951,""spending_outpoints"":[{""tx_index"":7156221572891745,""n"":932}],""n"":15,""tx_index"":8035426523688452,""script"":""a9142abbd28e0c72479821b9b21666d1dd3f9f0b33da87"",""addr"":""35ayJjbtTcoTyc53c3ne3dFkx4kye4t2CZ""},{""type"":0,""spent"":true,""value"":133870,""spending_outpoints"":[{""tx_index"":7685852859298851,""n"":521}],""n"":16,""tx_index"":8035426523688452,""script"":""a914d1f2921ac9ea3a127c50e40988de0ea0c171121387"",""addr"":""3Lq7jkC78BesCw7carqPv9L5ehcB6GChYT""},{""type"":0,""spent"":true,""value"":296019,""spending_outpoints"":[{""tx_index"":3211987983301831,""n"":10}],""n"":17,""tx_index"":8035426523688452,""script"":""001460bfcc621533538ddc49407467be8ba7a3a59eec"",""addr"":""bc1qvzluccs4xdfcmhzfgp6x005t5736t8hvfmly4e""},{""type"":0,""spent"":true,""value"":4848501709,""spending_outpoints"":[{""tx_index"":135639845877301,""n"":0}],""n"":18,""tx_index"":8035426523688452,""script"":""001408da93bfad48bddcdaf49e65248c3195a1838caa"",""addr"":""bc1qprdf80adfz7aekh5nejjfrp3jksc8r929svpxk""}]",1969,7995725260973
"5075b8ea5061b8f83ce31b9443b2ec01daf99eff48f890dec54c2a375c57a153",1,1,21,857,3098,75548,"0.0.0.0",0,2942477456041289,false,1682539056,787119,787119,"[{""sequence"":4294967295,""witness"":""024830450221008c1acd3eae6d0841c916e0f494983451c7de7002541174b256db92676ffc314d02201970c71186fda13f588fb023ac820ea8a4833d5a5e97d188c8f4890656812f930121022a51bd8200f44d72e94fa623ad6f79efb10fa6a873b5a8cf1c63b47f6301729b"",""script"":"""",""index"":0,""prev_out"":{""addr"":""bc1qprdf80adfz7aekh5nejjfrp3jksc8r929svpxk"",""n"":20,""script"":""001408da93bfad48bddcdaf49e65248c3195a1838caa"",""spending_outpoints"":[{""n"":0,""tx_index"":2942477456041289}],""spent"":true,""tx_index"":7909773977797235,""type"":0,""value"":5085678285}}]","[{""type"":0,""spent"":true,""value"":104096,""spending_outpoints"":[{""tx_index"":4151514116331817,""n"":10}],""n"":0,""tx_index"":2942477456041289,""script"":""a914c2588bf1aa5867593c1c41fb53d33cdc7edb720587"",""addr"":""3KQd665biNBoCaVvKJBzn5gNSb6n4PuD7d""},{""type"":0,""spent"":true,""value"":711266,""spending_outpoints"":[{""tx_index"":4883937755065066,""n"":85}],""n"":1,""tx_index"":2942477456041289,""script"":""a91412168709307c90642238e8cc9a22ef548f1295ce87"",""addr"":""33Lf5EWWnuxiLer9vycMfazfTiePiiC1ZH""},{""type"":0,""spent"":true,""value"":17000000,""spending_outpoints"":[{""tx_index"":8644773596770343,""n"":60}],""n"":2,""tx_index"":2942477456041289,""script"":""002099bb0e3b485c1d54a23ea96d349434ca1d319ca7dc64ae8b0bfcbe757616e9b8"",""addr"":""bc1qnxasuw6gtsw4fg3749knf9p5egwnr898m3j2azctljl82askaxuqtucdss""},{""type"":0,""spent"":true,""value"":171941,""spending_outpoints"":[{""tx_index"":2492298447278797,""n"":0}],""n"":3,""tx_index"":2942477456041289,""script"":""0014b18d36cce22694c67e0571c55ee4763ef6912dc9"",""addr"":""bc1qkxxndn8zy62vvls9w8z4aerk8mmfztwfhz9mt5""},{""type"":0,""spent"":true,""value"":349484,""spending_outpoints"":[{""tx_index"":1929900756484890,""n"":40}],""n"":4,""tx_index"":2942477456041289,""script"":""76a9149693d0239691d7774c7b91dc0b06365aa652d53a88ac"",""addr"":""1EjBS1HHk98DivbewgVRDhDkxdv4iaFDRW""},{""type"":0,""spent"":true,""value"":3000000,""spending_outpoints"":[{""tx_index"":337634978484534,""n"":751}],""n"":5,""tx_index"":2942477456041289,""script"":""a9149c2580ab6db6f724549a329e918a6096242b8ce887"",""addr"":""3FveGCN3G6rpJWcNDUXS9xEsa5BQwyjftY""},{""type"":0,""spent"":true,""value"":46636,""spending_outpoints"":[{""tx_index"":8804093662220117,""n"":80}],""n"":6,""tx_index"":2942477456041289,""script"":""a914c73dee3d8098287bf8eaf579782b9d5be8462f0687"",""addr"":""3KrWajVCBFotb4BT9b33DS8r7LbRru5gwT""},{""type"":0,""spent"":true,""value"":135019,""spending_outpoints"":[{""tx_index"":8010904518121722,""n"":55}],""n"":7,""tx_index"":2942477456041289,""script"":""a91463212bf7ec0ab17c93fe7f2d05e5f678c7ffa89787"",""addr"":""3AjAZMBDmYivcYvpY3A2ebrjyZBBajjTxG""},{""type"":0,""spent"":false,""value"":8387286,""spending_outpoints"":[],""n"":8,""tx_index"":2942477456041289,""script"":""00143f9d294530b77b148bc5a9cd4b5a725d01c827f4"",""addr"":""bc1q87wjj3fskaa3fz7948x5kknjt5qusfl562llrt""},{""type"":0,""spent"":true,""value"":92495,""spending_outpoints"":[{""tx_index"":5280391224265371,""n"":15}],""n"":9,""tx_index"":2942477456041289,""script"":""0020acee4aa61cbe43f6e2e11ea041bd979efd561bb6e73aef038de3c09a1ad28ce6"",""addr"":""bc1q4nhy4fsuhepldchpr6syr0vhnm74vxakuuaw7qudu0qf5xkj3nnqvlqss0""},{""type"":0,""spent"":false,""value"":1830,""spending_outpoints"":[],""n"":10,""tx_index"":2942477456041289,""script"":""76a914a0b0d60e5991578ed37cbda2b17d8b2ce23ab29588ac"",""addr"":""1FeexV6bAHb8ybZjqQMjJrcCrHGW9sb6uF""},{""type"":0,""spent"":true,""value"":213529,""spending_outpoints"":[{""tx_index"":7176216842182907,""n"":0}],""n"":11,""tx_index"":2942477456041289,""script"":""001485f13a5e6e7714a8506e2451ff78f305849b5f06"",""addr"":""bc1qshcn5hnwwu22s5rwy3gl778nqkzfkhcxku245e""},{""type"":0,""spent"":true,""value"":897879,""spending_outpoints"":[{""tx_index"":1978394879219492,""n"":115}],""n"":12,""tx_index"":2942477456041289,""script"":""0014c68dae6f6e7ce52ae565ad2d4b184c397dba2c51"",""addr"":""bc1qc6x6ummw0njj4et945k5kxzv897m5tz3xrtw8j""},{""type"":0,""spent"":true,""value"":1768809,""spending_outpoints"":[{""tx_index"":3911545928925227,""n"":1}],""n"":13,""tx_index"":2942477456041289,""script"":""76a914bece927f5f41e22e51f7570aa12fe42c46b33b0a88ac"",""addr"":""1JPtrLhvqpVUbE3dGVYrL4VY6Cea8CUkhB""},{""type"":0,""spent"":false,""value"":755610,""spending_outpoints"":[],""n"":14,""tx_index"":2942477456041289,""script"":""76a914baf4de5df7bbf6b42be020b925525405c0588cda88ac"",""addr"":""1J3Y2T8ci3MicmCa74YR4rT3FAEuoqwZB4""},{""type"":0,""spent"":true,""value"":69081,""spending_outpoints"":[{""tx_index"":1393802852951367,""n"":920}],""n"":15,""tx_index"":2942477456041289,""script"":""a914f94c8192be58d23480bfc47967ad50a427e95c5d87"",""addr"":""3QRBq3qSoUgajBR4BCauv6zRHVS74b5wkd""},{""type"":0,""spent"":true,""value"":356800,""spending_outpoints"":[{""tx_index"":5444339206972866,""n"":146}],""n"":16,""tx_index"":2942477456041289,""script"":""a91456c452cb9b0f910694bf471fcd3e44c5ce3811ad87"",""addr"":""39boDqBMT8uyMAkWyX9gvAoJTyhWDDJmRP""},{""type"":0,""spent"":true,""value"":1671678,""spending_outpoints"":[{""tx_index"":1963018380315254,""n"":41}],""n"":17,""tx_index"":2942477456041289,""script"":""a914bd9564547a6e0a28191962683bf09e1ba1e4332b87"",""addr"":""3JySbjQEs1oFyeEcpKbmMow9dnghoBZtqr""},{""type"":0,""spent"":true,""value"":28080,""spending_outpoints"":[{""tx_index"":1901798485338342,""n"":147}],""n"":18,""tx_index"":2942477456041289,""script"":""a914217560590e9059b1d111c146c03d1eacdef8e36587"",""addr"":""34jvqKtmEYbQqL9nRJvgZnSRXU7m9TBDsC""},{""type"":0,""spent"":true,""value"":53210,""spending_outpoints"":[{""tx_index"":1533316429162538,""n"":1}],""n"":19,""tx_index"":2942477456041289,""script"":""001463be5d213d3884059e2450647cb845c67ca52cb1"",""addr"":""bc1qvwl96gfa8zzqt83y2pj8ewz9ce722t93kjhu4l""},{""type"":0,""spent"":true,""value"":5049788008,""spending_outpoints"":[{""tx_index"":1350483527250942,""n"":0}],""n"":20,""tx_index"":2942477456041289,""script"":""001408da93bfad48bddcdaf49e65248c3195a1838caa"",""addr"":""bc1qprdf80adfz7aekh5nejjfrp3jksc8r929svpxk""}]",1830,7995725259004
"8d4bda9bbdabded7ec2c472c7ac3ec1eb38764a535a9adff00b7e22cfcc05e1c",1,1,21,839,3029,64804,"0.0.0.0",0,998185288178774,false,1682526850,787107,787107,"[{""sequence"":4294967295,""witness"":""02473044022013ea6606ed8cda9f70be4af4d11f26aeacce4b84dceb1a9d20da4626b8652fcc02207bb472432ff0e0ddc5e6f68ad79db999964350c1672f64c6665a0daf28ecdfbe0121022a51bd8200f44d72e94fa623ad6f79efb10fa6a873b5a8cf1c63b47f6301729b"",""script"":"""",""index"":0,""prev_out"":{""addr"":""bc1qprdf80adfz7aekh5nejjfrp3jksc8r929svpxk"",""n"":3,""script"":""001408da93bfad48bddcdaf49e65248c3195a1838caa"",""spending_outpoints"":[{""n"":0,""tx_index"":998185288178774}],""spent"":true,""tx_index"":8253164854349309,""type"":0,""value"":5730146451}}]","[{""type"":0,""spent"":true,""value"":335825,""spending_outpoints"":[{""tx_index"":4124944941741971,""n"":0}],""n"":0,""tx_index"":998185288178774,""script"":""00143d04ebdb9bf9abd179574437bea93492f9549854"",""addr"":""bc1q85zwhkumlx4az72hgsmma2f5jtu4fxz5yz98sm""},{""type"":0,""spent"":true,""value"":97322,""spending_outpoints"":[{""tx_index"":7849949901595122,""n"":860}],""n"":1,""tx_index"":998185288178774,""script"":""a914e85b3278c9ac6296b6fe760031b8d09ec39e55bb87"",""addr"":""3NsbwY9du2v5JiamjpokKw6n9cEKBYZtcy""},{""type"":0,""spent"":true,""value"":16700000,""spending_outpoints"":[{""tx_index"":7225777566140359,""n"":1}],""n"":2,""tx_index"":998185288178774,""script"":""0014407a7139fcb74c2d16fdbbbf5984111d87ec6ce8"",""addr"":""bc1qgpa8zw0ukaxz69hahwl4npq3rkr7cm8gq3md76""},{""type"":0,""spent"":true,""value"":498032,""spending_outpoints"":[{""tx_index"":1046223167907520,""n"":0}],""n"":3,""tx_index"":998185288178774,""script"":""00144cea5ae37024fa116bdf1dfa1bf88451d0ff1fab"",""addr"":""bc1qfn494cmsynapz67lrhaph7yy28g078atnzwmcy""},{""type"":0,""spent"":true,""value"":430229,""spending_outpoints"":[{""tx_index"":4587894663479800,""n"":84}],""n"":4,""tx_index"":998185288178774,""script"":""0014ee15b959c65b88664e8ace6b59b1ae9afc2d9f8e"",""addr"":""bc1qac2mjkwxtwyxvn52ee44nvdwnt7zm8uwf2y2kc""},{""type"":0,""spent"":true,""value"":15295638,""spending_outpoints"":[{""tx_index"":557665273773038,""n"":1}],""n"":5,""tx_index"":998185288178774,""script"":""00144adae771b6caf01c2160b8d436cd9d67aa0f1277"",""addr"":""bc1qftdwwudketcpcgtqhr2rdnvav74q7ynhq08ur5""},{""type"":0,""spent"":true,""value"":188040,""spending_outpoints"":[{""tx_index"":4097487597774238,""n"":10}],""n"":6,""tx_index"":998185288178774,""script"":""a914a7e14412b327e3ffee02c1f817e28fc8ff52619b87"",""addr"":""3GzgdL3wgmLtdyeehpB9eiQA8gt5JXzurY""},{""type"":0,""spent"":false,""value"":8500000,""spending_outpoints"":[],""n"":7,""tx_index"":998185288178774,""script"":""0014b1185499efc33fb24e820058b450a966c1dbc5e9"",""addr"":""bc1qkyv9fx00cvlmyn5zqpvtg59fvmqah30fkrlwe4""},{""type"":0,""spent"":true,""value"":130432,""spending_outpoints"":[{""tx_index"":6574752551297765,""n"":0}],""n"":8,""tx_index"":998185288178774,""script"":""00141fb2de9e612de5655d47d3946e4471c415098b59"",""addr"":""bc1qr7eda8np9hjk2h286w2xu3r3cs2snz6e48rcv0""},{""type"":0,""spent"":true,""value"":68427,""spending_outpoints"":[{""tx_index"":975466319821873,""n"":1}],""n"":9,""tx_index"":998185288178774,""script"":""00149df8e8c14eb28ee819e73de2eacd326623106af5"",""addr"":""bc1qnhuw3s2wk28wsx088h3w4nfjvc33q6h42arx7r""},{""type"":0,""spent"":true,""value"":242017,""spending_outpoints"":[{""tx_index"":455055002012447,""n"":20}],""n"":10,""tx_index"":998185288178774,""script"":""76a9140a0bd1d00496698ebbf591303b7b5a204575ff0088ac"",""addr"":""1v7vA7djvU9yrThsjXq9sp79TMAK2vVkc""},{""type"":0,""spent"":true,""value"":127610,""spending_outpoints"":[{""tx_index"":5183422513772470,""n"":156}],""n"":11,""tx_index"":998185288178774,""script"":""a9147080365140cec7166b39415f76cd3e20fa8a95e787"",""addr"":""3BwsCNEtgo14Hxtf2EDxQnzRBqgKswgXbF""},{""type"":0,""spent"":true,""value"":171186,""spending_outpoints"":[{""tx_index"":8778437050585716,""n"":24}],""n"":12,""tx_index"":998185288178774,""script"":""a914afbac70a5bd685dbd0ea12700df5938ddf0f7a0c87"",""addr"":""3HiBveDLS5ekzJnHGWXiu717nyEW1NjNdt""},{""type"":0,""spent"":true,""value"":84026,""spending_outpoints"":[{""tx_index"":7141749324393226,""n"":905}],""n"":13,""tx_index"":998185288178774,""script"":""a9144fd37d1887a127e3c53f38ace2fc5d2ed5418b5f87"",""addr"":""38y6fBqs6QV6SzVuwhMQ3kEkWCkMqzk25s""},{""type"":0,""spent"":true,""value"":172638,""spending_outpoints"":[{""tx_index"":7156221572891745,""n"":553}],""n"":14,""tx_index"":998185288178774,""script"":""a9144f86fc3b4d98187d4e01c461d9661feec726e5cd87"",""addr"":""38wX1e5Jmks7ujjwahabyWzqmvaSNvPa97""},{""type"":0,""spent"":true,""value"":46350,""spending_outpoints"":[{""tx_index"":6636977113322027,""n"":77}],""n"":15,""tx_index"":998185288178774,""script"":""a91463212bf7ec0ab17c93fe7f2d05e5f678c7ffa89787"",""addr"":""3AjAZMBDmYivcYvpY3A2ebrjyZBBajjTxG""},{""type"":0,""spent"":false,""value"":1222,""spending_outpoints"":[],""n"":16,""tx_index"":998185288178774,""script"":""76a914a0b0d60e5991578ed37cbda2b17d8b2ce23ab29588ac"",""addr"":""1FeexV6bAHb8ybZjqQMjJrcCrHGW9sb6uF""},{""type"":0,""spent"":true,""value"":175129,""spending_outpoints"":[{""tx_index"":2938151453400844,""n"":55}],""n"":17,""tx_index"":998185288178774,""script"":""0020f1f4cbc0040bb140fbfabb408426aaa5f5a13d1128c3d2e5d30a74768795ad1c"",""addr"":""bc1q786vhsqypwc5p7l6hdqggf425h66z0g39rpa9ewnpf68dpu445wq7euxfh""},{""type"":0,""spent"":false,""value"":16781458,""spending_outpoints"":[],""n"":18,""tx_index"":998185288178774,""script"":""0014d821fee0a2f2642def21f7210b4ec09e9b4163f4"",""addr"":""bc1qmqslac9z7fjzmmep7ussknkqn6d5zcl5fdr9fs""},{""type"":0,""spent"":true,""value"":163129,""spending_outpoints"":[{""tx_index"":5106163352653995,""n"":16}],""n"":19,""tx_index"":998185288178774,""script"":""76a9148e4c915c1e1822786f8d0fd87a703da53b72f04688ac"",""addr"":""1DyQgGMdZgT1e4NBwuGp8oWjQJmsaknQmp""},{""type"":0,""spent"":true,""value"":5669872937,""spending_outpoints"":[{""tx_index"":274392697930429,""n"":0}],""n"":20,""tx_index"":998185288178774,""script"":""001408da93bfad48bddcdaf49e65248c3195a1838caa"",""addr"":""bc1qprdf80adfz7aekh5nejjfrp3jksc8r929svpxk""}]",1222,7995725257174
"1d83afe53ea01a000eb6b0a8ee7f9bbec81f3b493fc016827a8564de30903c1c",1,1,21,855,3093,57010,"0.0.0.0",0,993486167592080,false,1682462379,787003,787003,"[{""sequence"":4294967295,""witness"":""02473044022006abbda2212339c5f821a80fbb6f4541609eb52fcd837b20edf28e32527d142b022029a1552ccd25a4719591a660c956ed1ac75e175a0c81fa8a111b1215e20b05a90121022a51bd8200f44d72e94fa623ad6f79efb10fa6a873b5a8cf1c63b47f6301729b"",""script"":"""",""index"":0,""prev_out"":{""addr"":""bc1qprdf80adfz7aekh5nejjfrp3jksc8r929svpxk"",""n"":20,""script"":""001408da93bfad48bddcdaf49e65248c3195a1838caa"",""spending_outpoints"":[{""n"":0,""tx_index"":993486167592080}],""spent"":true,""tx_index"":491841102895897,""type"":0,""value"":12549965776}}]","[{""type"":0,""spent"":true,""value"":11626979,""spending_outpoints"":[{""tx_index"":2279290484343685,""n"":1}],""n"":0,""tx_index"":993486167592080,""script"":""76a91479bd809c5ef5168c36190ed318829f56be7d2d7388ac"",""addr"":""1C6hn4x4hu73ZS7PhcCwd7CFaGZF4LbrBv""},{""type"":0,""spent"":true,""value"":1951822,""spending_outpoints"":[{""tx_index"":4502595192306966,""n"":1}],""n"":1,""tx_index"":993486167592080,""script"":""76a914d6feb9ef2a9cf3278d3ad2108f01c77c41d002ad88ac"",""addr"":""1LbnkkFYvjaXUtRMnUeTWEaGCkugYEKk5f""},{""type"":0,""spent"":true,""value"":1084175,""spending_outpoints"":[{""tx_index"":4038414069891677,""n"":0}],""n"":2,""tx_index"":993486167592080,""script"":""76a9142450ea1ca6cc74be7016f8fd23fe58b61863f14588ac"",""addr"":""14K2FwkG7z4oXsK6LtgcXWmQ7tzo6goGKF""},{""type"":0,""spent"":true,""value"":212408,""spending_outpoints"":[{""tx_index"":6941703391881551,""n"":0}],""n"":3,""tx_index"":993486167592080,""script"":""0014a3332f0b48621b556a4470beb01a5ed58a104150"",""addr"":""bc1q5vej7z6gvgd426jywzltqxj76k9pqs2s0pazp5""},{""type"":0,""spent"":true,""value"":74374,""spending_outpoints"":[{""tx_index"":3796935408398262,""n"":0}],""n"":4,""tx_index"":993486167592080,""script"":""001486b21fd8978169fafe6b8b5b015b0617c6e0617f"",""addr"":""bc1qs6eplkyhs95l4lnt3ddszkcxzlrwqctlcne7fq""},{""type"":0,""spent"":true,""value"":3509437,""spending_outpoints"":[{""tx_index"":2104065164898757,""n"":175}],""n"":5,""tx_index"":993486167592080,""script"":""0020b5aa46ea762d449692a44b6d135aa1ecd65db4cc7a2d01e9ff69e5e1bfd88bd6"",""addr"":""bc1qkk4yd6nk94zfdy4yfdk3xk4pant9mdxv0gksr60ld8j7r07c30tqetjc54""},{""type"":0,""spent"":true,""value"":1205261,""spending_outpoints"":[{""tx_index"":505959821102586,""n"":13}],""n"":6,""tx_index"":993486167592080,""script"":""76a914e140f466d7bfc92d39fbc4c62ec1ab13a972ac1688ac"",""addr"":""1MY2rJ14b8t8Nuq2v8GwPkWBtKUN2f9cpT""},{""type"":0,""spent"":true,""value"":50984,""spending_outpoints"":[{""tx_index"":8176604452211783,""n"":2}],""n"":7,""tx_index"":993486167592080,""script"":""76a914b8dba1f62405911af72fefbfb2c82d4ec7c0ab8288ac"",""addr"":""1HrSSeDeCtNieWkuG5cQrAC5pMGNRmCLju""},{""type"":0,""spent"":true,""value"":229273,""spending_outpoints"":[{""tx_index"":3512790067493117,""n"":49}],""n"":8,""tx_index"":993486167592080,""script"":""a91492fca35308b586fd16ae08a8dd4505198c98041f87"",""addr"":""3F6DE9RL86A57yQcFjSA8x17Avz14ftH46""},{""type"":0,""spent"":true,""value"":120323,""spending_outpoints"":[{""tx_index"":5829980312129651,""n"":616}],""n"":9,""tx_index"":993486167592080,""script"":""00146dc055b2ccaf49574c591c8e5da27b52c3791601"",""addr"":""bc1qdhq9tvkv4ay4wnzerj89mgnm2tphj9spuek58e""},{""type"":0,""spent"":true,""value"":105851,""spending_outpoints"":[{""tx_index"":5262083093885728,""n"":12}],""n"":10,""tx_index"":993486167592080,""script"":""0014d1c18894c3edd541a534cd5885f5afcc9c0fc799"",""addr"":""bc1q68qc39xrah25rff5e4vgtad0ejwql3uevdlq68""},{""type"":0,""spent"":false,""value"":42602,""spending_outpoints"":[],""n"":11,""tx_index"":993486167592080,""script"":""a91405529796a0d149f268afa610f5c60e6fd4540ee087"",""addr"":""32BAF75KBmKUNz3dLtRKScmbiAKmMdUuQ8""},{""type"":0,""spent"":true,""value"":106357,""spending_outpoints"":[{""tx_index"":104461676623666,""n"":103}],""n"":12,""tx_index"":993486167592080,""script"":""a914ec7dae85f9a4bab8fa017542807fff0c2e3cef9287"",""addr"":""3PFTxLR3Qctbcsq5amN2mgX2dNfYmnnqJ9""},{""type"":0,""spent"":true,""value"":900925,""spending_outpoints"":[{""tx_index"":4710001462850871,""n"":5}],""n"":13,""tx_index"":993486167592080,""script"":""a914e5f49abe8f44d2ce396d40a5e235a47906a5ff3987"",""addr"":""3NeugtYPvUuSafwWNNd2an5Jg6XBQBJj8R""},{""type"":0,""spent"":true,""value"":10500,""spending_outpoints"":[{""tx_index"":54815722415432,""n"":105}],""n"":14,""tx_index"":993486167592080,""script"":""0014840ad9e59fe10f1ec370223f618d8654a303e6f1"",""addr"":""bc1qss9dnevluy83asmsyglkrrvx2j3s8eh32p7k05""},{""type"":0,""spent"":true,""value"":1787229,""spending_outpoints"":[{""tx_index"":2412493304168959,""n"":0}],""n"":15,""tx_index"":993486167592080,""script"":""a9141985d852cc6256b6501e113abac2c3e81b4729a787"",""addr"":""341yA46BQgnfAqAqe7gUnpzGudzpcGNXSi""},{""type"":0,""spent"":true,""value"":138906,""spending_outpoints"":[{""tx_index"":6917512049312659,""n"":12}],""n"":16,""tx_index"":993486167592080,""script"":""76a914669ffed1be318038b639de7e183c21e810fd04de88ac"",""addr"":""1AMdbEzD7MQSHvNYV7mu2AsFqsdbr9Ccof""},{""type"":0,""spent"":true,""value"":191071,""spending_outpoints"":[{""tx_index"":4271837055977896,""n"":10}],""n"":17,""tx_index"":993486167592080,""script"":""76a914b3fc056d2074ebe71a265337ecf6a68197fb7b1988ac"",""addr"":""1HQfs5VDmJTW4uPaA9NYmCnZiF6WSLjZUq""},{""type"":0,""spent"":true,""value"":138375,""spending_outpoints"":[{""tx_index"":8763115390636560,""n"":35}],""n"":18,""tx_index"":993486167592080,""script"":""76a914cf30d7df4806be6326f8c12e0f73d90787d10f2088ac"",""addr"":""1KtXPQ439mH3s8TWsEFmC1DifycxAMmvX1""},{""type"":0,""spent"":false,""value"":1621,""spending_outpoints"":[],""n"":19,""tx_index"":993486167592080,""script"":""76a914a0b0d60e5991578ed37cbda2b17d8b2ce23ab29588ac"",""addr"":""1FeexV6bAHb8ybZjqQMjJrcCrHGW9sb6uF""},{""type"":0,""spent"":true,""value"":12526420293,""spending_outpoints"":[{""tx_index"":3442648224179763,""n"":0}],""n"":20,""tx_index"":993486167592080,""script"":""001408da93bfad48bddcdaf49e65248c3195a1838caa"",""addr"":""bc1qprdf80adfz7aekh5nejjfrp3jksc8r929svpxk""}]",1621,7995725255952
"171930cd48e5cbf767742891ac91568bbc441640bad667a7df39bf1191ba5b83",1,1,21,849,3066,59117,"0.0.0.0",0,4621759850624999,false,1682453475,786988,786988,"[{""sequence"":4294967295,""witness"":""02483045022100f379dfd060582c84a0dffb655fe75ecef6a2ca936f989fac307fadf9927b7b3b02204608c215f7a98c9623bdc5ead561d3413d7e52f72c62feeb46e174f2cfb409190121022a51bd8200f44d72e94fa623ad6f79efb10fa6a873b5a8cf1c63b47f6301729b"",""script"":"""",""index"":0,""prev_out"":{""addr"":""bc1qprdf80adfz7aekh5nejjfrp3jksc8r929svpxk"",""n"":19,""script"":""001408da93bfad48bddcdaf49e65248c3195a1838caa"",""spending_outpoints"":[{""n"":0,""tx_index"":4621759850624999}],""spent"":true,""tx_index"":1728185186353314,""type"":0,""value"":7587859878}}]","[{""type"":0,""spent"":true,""value"":778373,""spending_outpoints"":[{""tx_index"":2134154869442483,""n"":1}],""n"":0,""tx_index"":4621759850624999,""script"":""76a9144f32f26effffe244448d87478a060019a4e1181388ac"",""addr"":""18DmR1rJ6ccp1HCnnuRRXVRQRYuqZMXx7d""},{""type"":0,""spent"":false,""value"":2222,""spending_outpoints"":[],""n"":1,""tx_index"":4621759850624999,""script"":""76a914a0b0d60e5991578ed37cbda2b17d8b2ce23ab29588ac"",""addr"":""1FeexV6bAHb8ybZjqQMjJrcCrHGW9sb6uF""},{""type"":0,""spent"":true,""value"":83186,""spending_outpoints"":[{""tx_index"":1762362593918985,""n"":29}],""n"":2,""tx_index"":4621759850624999,""script"":""a914d70d04328d008f7bef620b8e958740aeca4dbcd587"",""addr"":""3MJ6oBXjfnPfyCRjnhQZNWpiH2KaeNfiZY""},{""type"":0,""spent"":true,""value"":467087,""spending_outpoints"":[{""tx_index"":2471595003898129,""n"":168}],""n"":3,""tx_index"":4621759850624999,""script"":""0014bcb80dee8d19d5b876f2d8419101d9349fc0e977"",""addr"":""bc1qhjuqmm5dr82msahjmpqezqwexj0up6thjnc62a""},{""type"":0,""spent"":true,""value"":359421,""spending_outpoints"":[{""tx_index"":4687326017819281,""n"":446}],""n"":4,""tx_index"":4621759850624999,""script"":""0014d3dfb54081331626cbff16b175a1f52ce22794ef"",""addr"":""bc1q600m2sypxvtzdjllz6chtg049n3z0980g0pc6d""},{""type"":0,""spent"":true,""value"":7239580,""spending_outpoints"":[{""tx_index"":362766426096461,""n"":18}],""n"":5,""tx_index"":4621759850624999,""script"":""00147f22bab2f8d01210b52d65809650ee3cff8c294f"",""addr"":""bc1q0u3t4vhc6qfppdfdvkqfv58w8nlcc220gy0tr0""},{""type"":0,""spent"":true,""value"":181035,""spending_outpoints"":[{""tx_index"":6688958657992719,""n"":0}],""n"":6,""tx_index"":4621759850624999,""script"":""76a914b7b7c54fdb5d34fb2f7be0e33523bf713ad8d1da88ac"",""addr"":""1HkQoino5V8Zw5pVcCbSsJMT9csG6XpTCC""},{""type"":0,""spent"":true,""value"":126708,""spending_outpoints"":[{""tx_index"":175756122322785,""n"":83}],""n"":7,""tx_index"":4621759850624999,""script"":""a914ce65b070e8ac66ae5830707b1a416114dcc802c787"",""addr"":""3LWLwYxp77TPbP3gXSdtTK9iYJprM4WF1u""},{""type"":0,""spent"":true,""value"":428821,""spending_outpoints"":[{""tx_index"":7195498733433612,""n"":15}],""n"":8,""tx_index"":4621759850624999,""script"":""a914073ee9ec399a789724c6a267bcc7289d36e52fc187"",""addr"":""32ML2DD4ZX6QN8yoUWav1BVu5Tywu9TrZo""},{""type"":0,""spent"":true,""value"":400000,""spending_outpoints"":[{""tx_index"":7825068174205537,""n"":56}],""n"":9,""tx_index"":4621759850624999,""script"":""a9145ed72bb8cc496fc2d207e1a781d1c1ce341f488387"",""addr"":""3ALVCuQK5H6GhkdC63jBTXCGocer1EFC6k""},{""type"":0,""spent"":true,""value"":104710,""spending_outpoints"":[{""tx_index"":5058868958578084,""n"":171}],""n"":10,""tx_index"":4621759850624999,""script"":""00206d2087485a47e2fef5e3cf9e00f7af5d1329055f4077194ae495483c7e296ac4"",""addr"":""bc1qd5sgwjz6gl30aa0re70qpaa0t5fjjp2lgpm3jjhyj4yrcl3fdtzqc3gm9x""},{""type"":0,""spent"":true,""value"":202763,""spending_outpoints"":[{""tx_index"":3074856291882431,""n"":198}],""n"":11,""tx_index"":4621759850624999,""script"":""0014587b0cfe7f9da7dfefc3b76db870be340aff8965"",""addr"":""bc1qtpaselnlnknalm7rkakmsu97xs90lzt9w000ju""},{""type"":0,""spent"":true,""value"":125900,""spending_outpoints"":[{""tx_index"":2302037071870349,""n"":78}],""n"":12,""tx_index"":4621759850624999,""script"":""a914ee64a2db99bb03c077fc45b96674cdd52e6f5e4087"",""addr"":""3PRXJXGJNTAs8qdRca5SvPD5GjzpWzpfRf""},{""type"":0,""spent"":true,""value"":1082946,""spending_outpoints"":[{""tx_index"":6015370893830408,""n"":15}],""n"":13,""tx_index"":4621759850624999,""script"":""a914072389fc56109fe920cc0b5924aee341ee9b8a6087"",""addr"":""32LmEBPtZat9BAH1pCyfobHzuYi3xVhP4X""},{""type"":0,""spent"":true,""value"":719,""spending_outpoints"":[{""tx_index"":5137924763292818,""n"":0}],""n"":14,""tx_index"":4621759850624999,""script"":""76a9140fc5a09efc6ee51ee605dab3e800e1405feeff4f88ac"",""addr"":""12SPtGm8JHcztFPRBhSACho8JaZACyu6hL""},{""type"":0,""spent"":true,""value"":112707,""spending_outpoints"":[{""tx_index"":5532914621591025,""n"":15}],""n"":15,""tx_index"":4621759850624999,""script"":""a91461ae5f4109a46aabad4aa27e0e5cdb4e5fc8b08f87"",""addr"":""3AbWMjezwvVXN6h2vz5qAx3oYmzGiGNYYU""},{""type"":0,""spent"":true,""value"":1449693,""spending_outpoints"":[{""tx_index"":1337432159954197,""n"":476}],""n"":16,""tx_index"":4621759850624999,""script"":""a914cfe06336e21e447b027f7870dd890261dda8f18c87"",""addr"":""3LeAbyQhe6wHidcxVd7oat8se9QVJUmtC6""},{""type"":0,""spent"":true,""value"":18099530,""spending_outpoints"":[{""tx_index"":7758971696838650,""n"":7}],""n"":17,""tx_index"":4621759850624999,""script"":""76a914b8679e144263f2998f44f8fc22582ddb20bd8a4d88ac"",""addr"":""1Hp3TmU7AggjJYaKG7fB6hdeJa9agnL2Xt""},{""type"":0,""spent"":true,""value"":150000,""spending_outpoints"":[{""tx_index"":175756122322785,""n"":861}],""n"":18,""tx_index"":4621759850624999,""script"":""a9140270d6960dbfb8a80045c9cd5b3746d8325a4f5187"",""addr"":""31uvT4iX7e5aGP5Zs5s3a93UuFiVCkqNSt""},{""type"":0,""spent"":true,""value"":1809987,""spending_outpoints"":[{""tx_index"":5301341240692594,""n"":0}],""n"":19,""tx_index"":4621759850624999,""script"":""a914ba1eaef05658024dbc841a91920a7ce79bb9b2d987"",""addr"":""3Jf8N98q9JW6KDCrjVwnJXketm5wAu9qYp""},{""type"":0,""spent"":true,""value"":7554595373,""spending_outpoints"":[{""tx_index"":5011133145336744,""n"":0}],""n"":20,""tx_index"":4621759850624999,""script"":""001408da93bfad48bddcdaf49e65248c3195a1838caa"",""addr"":""bc1qprdf80adfz7aekh5nejjfrp3jksc8r929svpxk""}]",2222,7995725254331
"59bf3782595fd5932a4d644472f915a532d7c0699c233462eec6c900ebd5a23d",1,1,21,844,3046,53499,"0.0.0.0",0,2168626654222648,false,1682446831,786980,786980,"[{""sequence"":4294967295,""witness"":""02483045022100cec816ec60c17fd00f3e338d0b98b4fe4c3eb32acc9d03a1d95beb713b605cda0220686d7e94403282576f7e87fc74b5d21290864891c0d9f8ad0c993a69360a1fd90121022a51bd8200f44d72e94fa623ad6f79efb10fa6a873b5a8cf1c63b47f6301729b"",""script"":"""",""index"":0,""prev_out"":{""addr"":""bc1qprdf80adfz7aekh5nejjfrp3jksc8r929svpxk"",""n"":20,""script"":""001408da93bfad48bddcdaf49e65248c3195a1838caa"",""spending_outpoints"":[{""n"":0,""tx_index"":2168626654222648}],""spent"":true,""tx_index"":8953306928129724,""type"":0,""value"":7674938240}}]","[{""type"":0,""spent"":true,""value"":724477,""spending_outpoints"":[{""tx_index"":5018038325784155,""n"":0}],""n"":0,""tx_index"":2168626654222648,""script"":""0014e89f8ebc2ee391bb20a937b93430dcbcfa4bec87"",""addr"":""bc1qaz0ca0pwuwgmkg9fx7ungvxuhnayhmy8uzplpx""},{""type"":0,""spent"":true,""value"":90518,""spending_outpoints"":[{""tx_index"":4813240158338480,""n"":338}],""n"":1,""tx_index"":2168626654222648,""script"":""00143ab6959803c1915bc2288105edc91c3d43372c44"",""addr"":""bc1q82mftxqrcxg4hs3gsyz7mjgu84pnwtzyct3p0u""},{""type"":0,""spent"":true,""value"":1444089,""spending_outpoints"":[{""tx_index"":5013676395253905,""n"":15}],""n"":2,""tx_index"":2168626654222648,""script"":""a914a862d31dde46ff9635fe4f5fcddf524aa3b9b7ca87"",""addr"":""3H3MqEJ4UcAwkeBJZf1rtTxBfnJM48CL9d""},{""type"":0,""spent"":true,""value"":100582,""spending_outpoints"":[{""tx_index"":4440247526929694,""n"":965}],""n"":3,""tx_index"":2168626654222648,""script"":""a91425477eef537e1cd68a2288b99afe532926b9c26687"",""addr"":""3568aG1A6W81e2CeEeWaeq89FWpgVa9S5h""},{""type"":0,""spent"":true,""value"":299305,""spending_outpoints"":[{""tx_index"":2128205498021766,""n"":992}],""n"":4,""tx_index"":2168626654222648,""script"":""a91484216bba5adf406f682b07613e0ca807d789d38387"",""addr"":""3Djf9z2pmHixDTdkPxXAYY5JJuYtD1c8KY""},{""type"":0,""spent"":true,""value"":3976921,""spending_outpoints"":[{""tx_index"":6072481526724675,""n"":0}],""n"":5,""tx_index"":2168626654222648,""script"":""76a914cadb7a18beafe793ed846fb0b2bfacaf980f643e88ac"",""addr"":""1KVcRGwi4HuKHFbp9Cr2rgfeZgk19X7wgJ""},{""type"":0,""spent"":true,""value"":3601600,""spending_outpoints"":[{""tx_index"":6991182828103946,""n"":3}],""n"":6,""tx_index"":2168626654222648,""script"":""a9145232719051462458c9f0413ddd3f10f9d8da653187"",""addr"":""39BdmA55cdxkAjog4kteZXKvYcwPM3L5xf""},{""type"":0,""spent"":true,""value"":127925,""spending_outpoints"":[{""tx_index"":3143668276953372,""n"":1}],""n"":7,""tx_index"":2168626654222648,""script"":""0014b59be4997c8dd2b7d07da0555efc4cba2420d954"",""addr"":""bc1qkkd7fxtu3hft05ra5p24alzvhgjzpk25dcpeqd""},{""type"":0,""spent"":true,""value"":365169,""spending_outpoints"":[{""tx_index"":5812693350315643,""n"":874}],""n"":8,""tx_index"":2168626654222648,""script"":""a914e6dff3f895a79b3506c9641dfe56d59981bcd8d787"",""addr"":""3NjmdC8rpQmK9hFAh62V5iBpM8ucX9rpA9""},{""type"":0,""spent"":true,""value"":74534,""spending_outpoints"":[{""tx_index"":2969645689951093,""n"":260}],""n"":9,""tx_index"":2168626654222648,""script"":""a914c88fb9541bc31c6250356b7c17d125df4b7ba22487"",""addr"":""3KyVF2MmhrbnzRN9BswBfGzX2bFZZx9XgQ""},{""type"":0,""spent"":true,""value"":662499,""spending_outpoints"":[{""tx_index"":3204635569182700,""n"":0}],""n"":10,""tx_index"":2168626654222648,""script"":""76a91411030b5085d50b24021b9b048da668f5d4c5d97988ac"",""addr"":""12Yx8mzL6cKHKpmN4srmnSaMj6kueyWjL3""},{""type"":0,""spent"":true,""value"":542199,""spending_outpoints"":[{""tx_index"":2599350085298233,""n"":33}],""n"":11,""tx_index"":2168626654222648,""script"":""0014d4e2e8422802fc3671768c122b4779ed67f56028"",""addr"":""bc1q6n3wss3gqt7rvutk3sfzk3mea4nl2cpgu58xf4""},{""type"":0,""spent"":true,""value"":18098,""spending_outpoints"":[{""tx_index"":3772448150971871,""n"":1}],""n"":12,""tx_index"":2168626654222648,""script"":""a91419e8f91c9cd89a45c90d01199e342fc5e673d89687"",""addr"":""3441ubPkaw8pHi4iR2sghdWAAWExhF9Kvq""},{""type"":0,""spent"":true,""value"":1795790,""spending_outpoints"":[{""tx_index"":1961004360099079,""n"":0}],""n"":13,""tx_index"":2168626654222648,""script"":""a91487fb5ed2f521bb2a16c069abfd56742ef5da704b87"",""addr"":""3E62GxoRVHPADehxTph32A32sNFhLhEVgm""},{""type"":0,""spent"":true,""value"":9617,""spending_outpoints"":[{""tx_index"":7557103028947235,""n"":72}],""n"":14,""tx_index"":2168626654222648,""script"":""a9141e57f204121449489cb9f93cf8c730455a343ec487"",""addr"":""34TTYrH4jnrcyYamLRLXZMEAvZhEUokMzE""},{""type"":0,""spent"":true,""value"":99000,""spending_outpoints"":[{""tx_index"":4440247526929694,""n"":895}],""n"":15,""tx_index"":2168626654222648,""script"":""a9141b8a392b9308fd82fc18c8ce0fc5c1ef3b6f6cc187"",""addr"":""34CdkeXmyjJs7cxPbGf2mQyBw8tVuTv8NE""},{""type"":0,""spent"":true,""value"":448772,""spending_outpoints"":[{""tx_index"":5890514447849400,""n"":110}],""n"":16,""tx_index"":2168626654222648,""script"":""0020bdfbe23f9dfb18bcd2496c648cd8956ba8dbc500c53902d39723af2412c5dca6"",""addr"":""bc1qhha7y0ualvvte5jfd3jgeky4dw5dh3gqc5us95uhywhjgyk9mjnqf700cn""},{""type"":0,""spent"":true,""value"":180935,""spending_outpoints"":[{""tx_index"":7730253333839690,""n"":101}],""n"":17,""tx_index"":2168626654222648,""script"":""a914e61469e7c757ca0e6aec7cfbba4a997f5a0b3d8987"",""addr"":""3NfZo2sGG2WTxS862v1FQqvXHrt4HGqTiL""},{""type"":0,""spent"":true,""value"":5274061,""spending_outpoints"":[{""tx_index"":8564477238713029,""n"":0}],""n"":18,""tx_index"":2168626654222648,""script"":""0014b7baebc3bd0f85a9be43af8d49a8c71cb22279b2"",""addr"":""bc1qk7awhsaap7z6n0jr47x5n2x8rjezy7djwezjuq""},{""type"":0,""spent"":false,""value"":6666,""spending_outpoints"":[],""n"":19,""tx_index"":2168626654222648,""script"":""76a914a0b0d60e5991578ed37cbda2b17d8b2ce23ab29588ac"",""addr"":""1FeexV6bAHb8ybZjqQMjJrcCrHGW9sb6uF""},{""type"":0,""spent"":true,""value"":7655041984,""spending_outpoints"":[{""tx_index"":270985392788007,""n"":0}],""n"":20,""tx_index"":2168626654222648,""script"":""001408da93bfad48bddcdaf49e65248c3195a1838caa"",""addr"":""bc1qprdf80adfz7aekh5nejjfrp3jksc8r929svpxk""}]",6666,7995725252109
"c52de017457cd991338b1d1b88cf18efc8950c9dfae97b76a73f71fdb1c15e88",1,1,19,780,2793,36128,"0.0.0.0",0,4798097855065639,false,1682350534,786831,786831,"[{""sequence"":4294967295,""witness"":""024730440220107f3a727b77840c2e82e47d62913296b3a04c99f7535da1acb0edc15dcdf8270220620db66a5a35427f9ac25a351eb507c2fc8733f9782271df45a4f59a4da834210121022a51bd8200f44d72e94fa623ad6f79efb10fa6a873b5a8cf1c63b47f6301729b"",""script"":"""",""index"":0,""prev_out"":{""addr"":""bc1qprdf80adfz7aekh5nejjfrp3jksc8r929svpxk"",""n"":1,""script"":""001408da93bfad48bddcdaf49e65248c3195a1838caa"",""spending_outpoints"":[{""n"":0,""tx_index"":4798097855065639}],""spent"":true,""tx_index"":8539623567912575,""type"":0,""value"":11881744486}}]","[{""type"":0,""spent"":true,""value"":176836,""spending_outpoints"":[{""tx_index"":1726301548959295,""n"":0}],""n"":0,""tx_index"":4798097855065639,""script"":""0014f56c88f1c117fdd184171229de83352bc5cc2f18"",""addr"":""bc1q74kg3uwpzl7arpqhzg5aaqe490zuctcccm42jg""},{""type"":0,""spent"":true,""value"":365551,""spending_outpoints"":[{""tx_index"":8435090365851385,""n"":23}],""n"":1,""tx_index"":4798097855065639,""script"":""0014add4b06031a4aa6ce5b23bad7a18dde8f2ce5fcd"",""addr"":""bc1q4h2tqcp35j4xeedj8wkh5xxaarevuh7d8jadgs""},{""type"":0,""spent"":true,""value"":1514168,""spending_outpoints"":[{""tx_index"":2455745826729196,""n"":20}],""n"":2,""tx_index"":4798097855065639,""script"":""001433ff13b99901e59652064aefbddfa1bc743b301f"",""addr"":""bc1qx0l38wveq8jev5sxfthmmhaph36rkvqlv5af6p""},{""type"":0,""spent"":false,""value"":1966,""spending_outpoints"":[],""n"":3,""tx_index"":4798097855065639,""script"":""76a914a0b0d60e5991578ed37cbda2b17d8b2ce23ab29588ac"",""addr"":""1FeexV6bAHb8ybZjqQMjJrcCrHGW9sb6uF""},{""type"":0,""spent"":true,""value"":475315,""spending_outpoints"":[{""tx_index"":903754470074709,""n"":0}],""n"":4,""tx_index"":4798097855065639,""script"":""76a914bd019b87178b29d3d8cfa780a82e124107a0b32188ac"",""addr"":""1JENdx3mRTXAq86he9ZcZKtwtN4zGfKg3B""},{""type"":0,""spent"":true,""value"":89229,""spending_outpoints"":[{""tx_index"":1053632570648618,""n"":28}],""n"":5,""tx_index"":4798097855065639,""script"":""76a91458a0c9e0acf15ef6e1d32a7396949ac2aba15bfe88ac"",""addr"":""195d5fjRkv9Pr3y2GsjW51Rgd8fHaTrLCT""},{""type"":0,""spent"":true,""value"":359107,""spending_outpoints"":[{""tx_index"":1420162053029459,""n"":211}],""n"":6,""tx_index"":4798097855065639,""script"":""a91486e26002e8b65a88108725427685cb24ec2f72c887"",""addr"":""3DzDf4biA7QDtBmpD8Z3hghRSQP5qgDGxG""},{""type"":0,""spent"":true,""value"":3655931,""spending_outpoints"":[{""tx_index"":599730282024199,""n"":2}],""n"":7,""tx_index"":4798097855065639,""script"":""76a914a986dc265b7010b4ca54603895e1c264f01be0eb88ac"",""addr"":""1GTNkeutVAUwnrLRf8g7rFaPHaDDL9Rgh3""},{""type"":0,""spent"":true,""value"":17485,""spending_outpoints"":[{""tx_index"":2732784348429411,""n"":0}],""n"":8,""tx_index"":4798097855065639,""script"":""001447e2b8b6cff7f7859c711d501116fab625fdfd78"",""addr"":""bc1qgl3t3dk07lmct8r3r4gpz9h6kcjlmltcq3um8c""},{""type"":0,""spent"":true,""value"":459446,""spending_outpoints"":[{""tx_index"":722250107293124,""n"":9}],""n"":9,""tx_index"":4798097855065639,""script"":""76a9141e6986e8b6c4f08588120739b7cf82ce94984f7988ac"",""addr"":""13mogu7vbkbsCbv8bNGgJV6b6Uky1JJvxT""},{""type"":0,""spent"":true,""value"":545112,""spending_outpoints"":[{""tx_index"":4034470730748707,""n"":77}],""n"":10,""tx_index"":4798097855065639,""script"":""a9146b11b5672b786308b8a16c47f094f92fab82a2c987"",""addr"":""3BT9SV66PNu46APGnDRu3c2iiMrVwfWVCg""},{""type"":0,""spent"":true,""value"":117169,""spending_outpoints"":[{""tx_index"":6714084284231185,""n"":291}],""n"":11,""tx_index"":4798097855065639,""script"":""a914769f9b0a3c7170e3a9249854f2188c55ff16d82e87"",""addr"":""3CWErmnYuadL31WGaKrmcQtRRCfmBxudQW""},{""type"":0,""spent"":true,""value"":86381,""spending_outpoints"":[{""tx_index"":5982763916567386,""n"":74}],""n"":12,""tx_index"":4798097855065639,""script"":""76a91407bf3ffe5c0483ab3b400280d33eddc2ba5a338c88ac"",""addr"":""1hxqdCFJUmHHGcU4TXhwUMQCKHU3LDXB4""},{""type"":0,""spent"":true,""value"":3650458,""spending_outpoints"":[{""tx_index"":823736429035749,""n"":795}],""n"":13,""tx_index"":4798097855065639,""script"":""a914e5e776b5e1ff648fcec991a827a10dadf8019bd987"",""addr"":""3NedwrTrwWBnFPCBd1w36BaWWVqBD7Ni2k""},{""type"":0,""spent"":true,""value"":2195464,""spending_outpoints"":[{""tx_index"":6073071845583475,""n"":0}],""n"":14,""tx_index"":4798097855065639,""script"":""76a9146c9c1fc9abbac25c456890ff86f8192556fca71488ac"",""addr"":""1AuH1R5w7K8VwWXZW5kuagG2y3eKeX4Emk""},{""type"":0,""spent"":true,""value"":178985,""spending_outpoints"":[{""tx_index"":5509448244356287,""n"":165}],""n"":15,""tx_index"":4798097855065639,""script"":""76a914a7ab7d61556ef70420160ea2e6283c6c8929446888ac"",""addr"":""1GHZHMWKL58DVK4wQsJ8svdNMPuUhYNyp8""},{""type"":0,""spent"":true,""value"":69345,""spending_outpoints"":[{""tx_index"":959936168384109,""n"":27}],""n"":16,""tx_index"":4798097855065639,""script"":""76a91462b9bbe3fd8d37b603dad5d4c83547f6c0d7a56888ac"",""addr"":""1A11ipaVbaGgvV5Lu7ZNggxdsRWsiMvzWv""},{""type"":0,""spent"":true,""value"":183870,""spending_outpoints"":[{""tx_index"":2455745826729196,""n"":21}],""n"":17,""tx_index"":4798097855065639,""script"":""0014a5523cbe4bfd8ae9749e2454dfb857da0a1b5fc4"",""addr"":""bc1q54fre0jtlk9wjay7y32dlwzhmg9pkh7y4e30gm""},{""type"":0,""spent"":true,""value"":11867566540,""spending_outpoints"":[{""tx_index"":4401414324760866,""n"":0}],""n"":18,""tx_index"":4798097855065639,""script"":""001408da93bfad48bddcdaf49e65248c3195a1838caa"",""addr"":""bc1qprdf80adfz7aekh5nejjfrp3jksc8r929svpxk""}]",1966,7995725245443
"d57e23dcdd50df6796e8c955e1488f46b862628a2e826f1968b59f3b5741d8aa",1,1,1,195,450,338,"0.0.0.0",0,6011065148601334,false,1682330835,786807,786807,"[{""sequence"":4294967295,""witness"":""02483045022100b4bad16336ae8b457b657c2deb393fe64c7167d107d85a8c55277f8d004004cd02200bf254d7b4996d2445c92f79929a0afb81f0615f217285c5eedc839bd9c463a3012103fa715eb713c719aa4395ee70bcae45516750d1b1786b2a6dbac81bde678ca5db"",""script"":"""",""index"":0,""prev_out"":{""addr"":""bc1qhrajxxr2j3sgfund8a8kv8vwm00aagq4th6pp6"",""n"":0,""script"":""0014b8fb23186a946084f26d3f4f661d8edbdfdea015"",""spending_outpoints"":[{""n"":0,""tx_index"":6011065148601334}],""spent"":true,""tx_index"":7658845431206326,""type"":0,""value"":1182}}]","[{""type"":0,""spent"":false,""value"":844,""spending_outpoints"":[],""n"":0,""tx_index"":6011065148601334,""script"":""76a914a0b0d60e5991578ed37cbda2b17d8b2ce23ab29588ac"",""addr"":""1FeexV6bAHb8ybZjqQMjJrcCrHGW9sb6uF""}]",844,7995725243477
"53c1f7f357532355ef9832d033bec42b4230981ab6085b5de774bee4081c0b89",1,1,21,837,3018,31089,"0.0.0.0",0,4821785855694798,false,1682292068,786741,786741,"[{""sequence"":4294967295,""witness"":""02483045022100c4d95d1de2bc2d2277dc0e32fd4e6eade8d6798ead6a520604c94d7ea45627fe0220584569d11f03b6671772a8089523987844c9235aaca5c2feb9716c5f5aeb877a0121022a51bd8200f44d72e94fa623ad6f79efb10fa6a873b5a8cf1c63b47f6301729b"",""script"":"""",""index"":0,""prev_out"":{""addr"":""bc1qprdf80adfz7aekh5nejjfrp3jksc8r929svpxk"",""n"":18,""script"":""001408da93bfad48bddcdaf49e65248c3195a1838caa"",""spending_outpoints"":[{""n"":0,""tx_index"":4821785855694798}],""spent"":true,""tx_index"":3669381178782900,""type"":0,""value"":14406311534}}]","[{""type"":0,""spent"":true,""value"":740000,""spending_outpoints"":[{""tx_index"":2799004887325794,""n"":1}],""n"":0,""tx_index"":4821785855694798,""script"":""0014247a58aea59305e2f9d9c055782eacca11701f83"",""addr"":""bc1qy3a93t49jvz797wecp2hst4vegghq8urydea5h""},{""type"":0,""spent"":true,""value"":10949,""spending_outpoints"":[{""tx_index"":4791976309393029,""n"":113}],""n"":1,""tx_index"":4821785855694798,""script"":""a914e220869678da78cfd6be7c2d2198c578630acffa87"",""addr"":""3NJfbpobaeM3Cewu6GSDxkTUcHQ9AHNUJv""},{""type"":0,""spent"":true,""value"":227706,""spending_outpoints"":[{""tx_index"":3134233685048858,""n"":2}],""n"":2,""tx_index"":4821785855694798,""script"":""76a914c050acac6fb78af0a2f7486100de29aa0637d80e88ac"",""addr"":""1JXsPCGxNE8J8EAUyZzS7cUanopus5NLdF""},{""type"":0,""spent"":false,""value"":1830,""spending_outpoints"":[],""n"":3,""tx_index"":4821785855694798,""script"":""76a914a0b0d60e5991578ed37cbda2b17d8b2ce23ab29588ac"",""addr"":""1FeexV6bAHb8ybZjqQMjJrcCrHGW9sb6uF""},{""type"":0,""spent"":true,""value"":88147,""spending_outpoints"":[{""tx_index"":7766932166176179,""n"":798}],""n"":4,""tx_index"":4821785855694798,""script"":""a914e365b59ef01637a067459663bcfebd464db2449487"",""addr"":""3NRP9z9n2G5JFsPjfUXwc3KRm8NySBUKQA""},{""type"":0,""spent"":true,""value"":727351,""spending_outpoints"":[{""tx_index"":2592341016006505,""n"":84}],""n"":5,""tx_index"":4821785855694798,""script"":""a91418f7f4b705e74ba55b160001e56c68a6a4fd86ab87"",""addr"":""33y3BRiGkxB3R2XRTmMcwNzoeHjh5PH96A""},{""type"":0,""spent"":true,""value"":151335,""spending_outpoints"":[{""tx_index"":7006767754398203,""n"":8}],""n"":6,""tx_index"":4821785855694798,""script"":""0014f6b6008e3968e4f9439aa852adf0f336ccad8f7d"",""addr"":""bc1q76mqpr3edrj0jsu64pf2mu8nxmx2mrmamwqzx2""},{""type"":0,""spent"":true,""value"":716778,""spending_outpoints"":[{""tx_index"":172278362930357,""n"":0}],""n"":7,""tx_index"":4821785855694798,""script"":""00149dc315f2bdbbf6fea580b30f86d8cf2a436d9b10"",""addr"":""bc1qnhp3tu4ah0m0afvqkv8cdkx09fpkmxcs78dn7l""},{""type"":0,""spent"":true,""value"":70651,""spending_outpoints"":[{""tx_index"":7415266856860695,""n"":9}],""n"":8,""tx_index"":4821785855694798,""script"":""0014674fcfee1d850faf678565e0a8eeaf58432562bf"",""addr"":""bc1qva8ulmsas5867eu9vhs23m40tppj2c4lz34aac""},{""type"":0,""spent"":false,""value"":179451,""spending_outpoints"":[],""n"":9,""tx_index"":4821785855694798,""script"":""a9148e83b769c9d7472e9efe464c489b0f7a75389e4c87"",""addr"":""3EgZfbxp2eHmN5AQdQ7zgds9PXWsoWEqHJ""},{""type"":0,""spent"":true,""value"":4288202,""spending_outpoints"":[{""tx_index"":746270930887109,""n"":1}],""n"":10,""tx_index"":4821785855694798,""script"":""0014e52c7ca51de9721a364bf772ec6ca4c446956757"",""addr"":""bc1qu5k8efgaa9ep5djt7aewcm9yc3rf2e6hmupcft""},{""type"":0,""spent"":true,""value"":409415,""spending_outpoints"":[{""tx_index"":2777651543638789,""n"":38}],""n"":11,""tx_index"":4821785855694798,""script"":""76a91421ac639654903d73664a33afa68393a9ee510c4b88ac"",""addr"":""1453p8UuVArG4bspHU1ngxu1tvUSJVS1J8""},{""type"":0,""spent"":true,""value"":540030,""spending_outpoints"":[{""tx_index"":4097767003296324,""n"":460}],""n"":12,""tx_index"":4821785855694798,""script"":""a914dbdd9a7f0bf4fe3d5fae1830349466ba43880feb87"",""addr"":""3MjZNqRtt2LPRGU6iEPDgAyu62QFvUHPvR""},{""type"":0,""spent"":false,""value"":2498445,""spending_outpoints"":[],""n"":13,""tx_index"":4821785855694798,""script"":""0014a8663e57b8494185fd8f525d573f54d94cfbc964"",""addr"":""bc1q4pnru4acf9qctlv02fw4w065m9x0hjtynuuzpu""},{""type"":0,""spent"":true,""value"":1811391,""spending_outpoints"":[{""tx_index"":45065703902007,""n"":5}],""n"":14,""tx_index"":4821785855694798,""script"":""76a9143f50c368555a96e02cc80321e3f94800fe0a775588ac"",""addr"":""16mnKcsiW6DDKFkp2V2oEQoom8c1i6Amsw""},{""type"":0,""spent"":true,""value"":217297,""spending_outpoints"":[{""tx_index"":2464212532228715,""n"":5}],""n"":15,""tx_index"":4821785855694798,""script"":""0014cdae1667b05cb296bfac938f115e0a41076c5eb2"",""addr"":""bc1qekhpveastjefd0avjw83zhs2gyrkch4ja88qtc""},{""type"":0,""spent"":true,""value"":730000,""spending_outpoints"":[{""tx_index"":7106561996746980,""n"":4}],""n"":16,""tx_index"":4821785855694798,""script"":""76a91488221d86fe9c7bee07240f37c3e6d736652c7c2b88ac"",""addr"":""1DQomTwDY6oMRbMXbEXD6wpyNP75wPRh4q""},{""type"":0,""spent"":false,""value"":70637,""spending_outpoints"":[],""n"":17,""tx_index"":4821785855694798,""script"":""a9144fc7e97d1b0b8f659b5b6b505f46d43b47ce1dbc87"",""addr"":""38xrnqDdi2mZ3rEQLnpk7R3QgSVKes1ma3""},{""type"":0,""spent"":true,""value"":358789,""spending_outpoints"":[{""tx_index"":48565888183993,""n"":2}],""n"":18,""tx_index"":4821785855694798,""script"":""76a9143bc4af3f7d9cc23bccc4df19a3f4881dcc0bff7c88ac"",""addr"":""16T2VCf6SMBq2MWsTCXNqCr6N6FmDWHLsa""},{""type"":0,""spent"":true,""value"":200000,""spending_outpoints"":[{""tx_index"":3088483477791116,""n"":656}],""n"":19,""tx_index"":4821785855694798,""script"":""a9141c4eb48016a1dcd4d1ebcbf1aacbca718d6a65b387"",""addr"":""34Gh8STjM7vd9QVvym9w7SvV9PKJMTaVi4""},{""type"":0,""spent"":true,""value"":14392242041,""spending_outpoints"":[{""tx_index"":6854203452195806,""n"":0}],""n"":20,""tx_index"":4821785855694798,""script"":""001408da93bfad48bddcdaf49e65248c3195a1838caa"",""addr"":""bc1qprdf80adfz7aekh5nejjfrp3jksc8r929svpxk""}]",1830,7995725242633
"5e8fdbc17895f447a0a5ea2fbf2da9ca33ba5dd327d6565eb4557740a7b0d922",1,1,21,830,2990,34917,"0.0.0.0",0,1226187743956714,false,1682276146,786714,786714,"[{""sequence"":4294967295,""witness"":""0248304502210080d3ad08d073c0a9d436d37b742f6f76922db1db3aa7a57958ed0f5ef8198b1e022045b9f71e0d6ed1fa07ca6319f25b6d3ae559dc946719dcc0f3b6d19db40daf090121022a51bd8200f44d72e94fa623ad6f79efb10fa6a873b5a8cf1c63b47f6301729b"",""script"":"""",""index"":0,""prev_out"":{""addr"":""bc1qprdf80adfz7aekh5nejjfrp3jksc8r929svpxk"",""n"":20,""script"":""001408da93bfad48bddcdaf49e65248c3195a1838caa"",""spending_outpoints"":[{""n"":0,""tx_index"":1226187743956714}],""spent"":true,""tx_index"":3592424095391874,""type"":0,""value"":12782043912}}]","[{""type"":0,""spent"":true,""value"":8800000,""spending_outpoints"":[{""tx_index"":985568730676512,""n"":7}],""n"":0,""tx_index"":1226187743956714,""script"":""a9142b5fc071d7f618c8ed827bb9bfa62663dedda0cd87"",""addr"":""35eMgjrugtB6oYbShVmuufW8nPbmCymL1o""},{""type"":0,""spent"":true,""value"":105344,""spending_outpoints"":[{""tx_index"":8637508680516704,""n"":0}],""n"":1,""tx_index"":1226187743956714,""script"":""0014f2abd4ba948db5618aa7f78387da4bea1bad7e6c"",""addr"":""bc1q724afw553k6krz4877pc0kjtagd66lnv04zafy""},{""type"":0,""spent"":false,""value"":18000000,""spending_outpoints"":[],""n"":2,""tx_index"":1226187743956714,""script"":""001414769650a2010b7da7ac61fd26e212828144a8f3"",""addr"":""bc1qz3mfv59zqy9hmfavv87jdcsjs2q5f28nz948xj""},{""type"":0,""spent"":true,""value"":16643435,""spending_outpoints"":[{""tx_index"":8437418221127958,""n"":78}],""n"":3,""tx_index"":1226187743956714,""script"":""001403b29d053b56a49b7edf476a8d99c3f5b4bb7db4"",""addr"":""bc1qqwef6pfm26jfklklga4gmxwr7k6tkld58950w9""},{""type"":0,""spent"":true,""value"":98949,""spending_outpoints"":[{""tx_index"":6490044780057920,""n"":97}],""n"":4,""tx_index"":1226187743956714,""script"":""a91419de608e7a43c3e4f94d04e2cf4951d2b4c8118887"",""addr"":""343oDNnbr3bFuHEcmrSDuJiXLV2Ton6a6M""},{""type"":0,""spent"":true,""value"":30618,""spending_outpoints"":[{""tx_index"":3702385072736831,""n"":2}],""n"":5,""tx_index"":1226187743956714,""script"":""76a914baf24f5d77ddb7bc0d31a5cf46dc28f0c84a95c088ac"",""addr"":""1J3UxgCPf7wfsCWMX3wWsvgp6YKCZxNCyT""},{""type"":0,""spent"":true,""value"":363498,""spending_outpoints"":[{""tx_index"":8728403709720723,""n"":36}],""n"":6,""tx_index"":1226187743956714,""script"":""a9148dc77dd83e689f8b21e7c358f3bbc6a85b1eec8c87"",""addr"":""3EcgBWXVMCah9ydMXqaEFEYkzTFyzziTDm""},{""type"":0,""spent"":true,""value"":746728,""spending_outpoints"":[{""tx_index"":4626987666683842,""n"":670}],""n"":7,""tx_index"":1226187743956714,""script"":""a9147ab7429786fe9e8ec3e4f601f75ba420d5265f3b87"",""addr"":""3Cssu5ozRpgmSDXop32WQYr9pSBY2BszzB""},{""type"":0,""spent"":true,""value"":364338,""spending_outpoints"":[{""tx_index"":440905670596999,""n"":392}],""n"":8,""tx_index"":1226187743956714,""script"":""a914285000225f0d85388fd8f82ac3df98bb16e87d4987"",""addr"":""35NAnkW94xZmDDRf7cuS6opV7rx5WSWt98""},{""type"":0,""spent"":true,""value"":565043,""spending_outpoints"":[{""tx_index"":1361483371690853,""n"":0}],""n"":9,""tx_index"":1226187743956714,""script"":""00149d222e06b411702f0e026005048bcceff0519476"",""addr"":""bc1qn53zup45z9cz7rszvqzsfz7valc9r9rk9uqfp2""},{""type"":0,""spent"":false,""value"":1830,""spending_outpoints"":[],""n"":10,""tx_index"":1226187743956714,""script"":""76a914a0b0d60e5991578ed37cbda2b17d8b2ce23ab29588ac"",""addr"":""1FeexV6bAHb8ybZjqQMjJrcCrHGW9sb6uF""},{""type"":0,""spent"":true,""value"":55148,""spending_outpoints"":[{""tx_index"":3889900865165071,""n"":98}],""n"":11,""tx_index"":1226187743956714,""script"":""a914276bfd57082c24f4fcee47368e5f4d9e0f7bed4287"",""addr"":""35HTeGtT8Hc7Tdzf6M6wLumwGy7ThUwNn9""},{""type"":0,""spent"":true,""value"":3598884,""spending_outpoints"":[{""tx_index"":6964627289466911,""n"":0}],""n"":12,""tx_index"":1226187743956714,""script"":""0014a979cda152156fe4af97359817874cf1fbb9249e"",""addr"":""bc1q49uumg2jz4h7ftuhxkvp0p6v78amjfy7yqhccd""},{""type"":0,""spent"":true,""value"":5097321,""spending_outpoints"":[{""tx_index"":3220055898335672,""n"":21}],""n"":13,""tx_index"":1226187743956714,""script"":""001407e3178ef3d2557daf9cd4a3d69b59760459efb0"",""addr"":""bc1qql330rhn6f2hmtuu6j3adx6ewcz9nmas72daa8""},{""type"":0,""spent"":true,""value"":107127,""spending_outpoints"":[{""tx_index"":2609752000799211,""n"":45}],""n"":14,""tx_index"":1226187743956714,""script"":""a914c3729b6df78b55f90bb7573b404d61f748eb3c1e87"",""addr"":""3KWSyzeu2rmgALyDop5kWNMZsaE2bKZzW1""},{""type"":0,""spent"":true,""value"":992571,""spending_outpoints"":[{""tx_index"":1391971263912571,""n"":105}],""n"":15,""tx_index"":1226187743956714,""script"":""a9141166d9ef0df15361eee846367b7b951f03a0308b87"",""addr"":""33H2d3CcFQt3earSgnM5MsQUp1sfdD5CJW""},{""type"":0,""spent"":true,""value"":604773,""spending_outpoints"":[{""tx_index"":4626987666683842,""n"":326}],""n"":16,""tx_index"":1226187743956714,""script"":""a914ab1aca80f1d98b6df928c4b958eed2481659c01f87"",""addr"":""3HHjZpXG3txzMxwsKADfPDdmUHYRF6PTF4""},{""type"":0,""spent"":true,""value"":726639,""spending_outpoints"":[{""tx_index"":4731449242442890,""n"":24}],""n"":17,""tx_index"":1226187743956714,""script"":""76a914d0c0f467c9fb61f876f378491c4ea931f093318d88ac"",""addr"":""1L2nhdUhSkQqZVRN41PKibyXS4SUhKkNxd""},{""type"":0,""spent"":false,""value"":3637,""spending_outpoints"":[],""n"":18,""tx_index"":1226187743956714,""script"":""0014edf1750561363340b2892938de3d40af865558ba"",""addr"":""bc1qahch2ptpxce5pv5f9yudu02q47r92k96nuse29""},{""type"":0,""spent"":false,""value"":98241,""spending_outpoints"":[],""n"":19,""tx_index"":1226187743956714,""script"":""001427a58271aba231bfaf17845e16029e75405a68e2"",""addr"":""bc1qy7jcyudt5gcmltchs30pvq57w4q9568z55jex3""},{""type"":0,""spent"":true,""value"":12725004871,""spending_outpoints"":[{""tx_index"":5925273910728355,""n"":0}],""n"":20,""tx_index"":1226187743956714,""script"":""001408da93bfad48bddcdaf49e65248c3195a1838caa"",""addr"":""bc1qprdf80adfz7aekh5nejjfrp3jksc8r929svpxk""}]",1830,7995725240803
"191920c56cd4d9dd8f60382f8d68755cb045a828492f87380080d9d7aa3724e2",1,1,2,226,574,864,"0.0.0.0",0,7956645780585264,false,1682262892,786706,786706,"[{""sequence"":4294967293,""witness"":""024830450221009471db7ccb50bac57f751c4a96b49ed588babcf1de1c4c0b8841e251e5b4d528022079ebd6bb003fdc00402e22afc30d7a426c6b425f9421fec30cae5b7581cc3e1c0121026b43baaaafded1b5ab7b0ebc0d4169764ab686c478aae0f557baa5d082a18a3d"",""script"":"""",""index"":0,""prev_out"":{""addr"":""bc1qy7efacplhd7mnncl0cjcgwnu84p0u06mpu07j8"",""n"":1,""script"":""001427b29ee03fbb7db9cf1f7e25843a7c3d42fe3f5b"",""spending_outpoints"":[{""n"":0,""tx_index"":7956645780585264}],""spent"":true,""tx_index"":4970215308133232,""type"":0,""value"":1156412}}]","[{""type"":0,""spent"":false,""value"":666,""spending_outpoints"":[],""n"":0,""tx_index"":7956645780585264,""script"":""76a914a0b0d60e5991578ed37cbda2b17d8b2ce23ab29588ac"",""addr"":""1FeexV6bAHb8ybZjqQMjJrcCrHGW9sb6uF""},{""type"":0,""spent"":true,""value"":1154882,""spending_outpoints"":[{""tx_index"":7727703884173100,""n"":0}],""n"":1,""tx_index"":7956645780585264,""script"":""001447adc56ff744bc5c569e97fe07a383c35f8c376d"",""addr"":""bc1qg7ku2mlhgj79c457jllq0gurcd0ccdmd44ecgd""}]",666,7995725238973
"2157e417c6dce99ae39994dfee35429ba08737625dfef0b4373f2351100953bc",2,1,2,1147,1495,1122,"0.0.0.0",0,6626074251895911,false,1682244062,786665,786665,"[{""sequence"":4294967293,""witness"":""034055d481803d704c3e66bb8fd29b412c749d5f90b06c0f7ce807557dab0e1421e06a8b5bdbf67ae82efe6b3d1b2943cd7fa8103b070918e86f57c3ebede24839effd9e0320117f692257b2331233b5705ce9c682be8719ff1b2b64cbca290bd6faeb54423eac06a7db8ead8701750063036f7264010118746578742f706c61696e3b636861727365743d7574662d38004d0802246d656d65206272633230206973206120737570657220636f6f6c20636f696e20616e6420746f676574686572207769746820246f7264692069747320746865206f6e6c792062726332302063726561746564206f6e206d61726368203820323032332e204765742074686f736520246d656d6520627463207768616c657320737570706f727465727320616e6420776f726c642e0d0a0d0a486f6c64696e67206576656e20612073696e676c6520246d656d652077696c6c206265206c696665206368616e67696e6720696e206675747572652e0d0a486f6c64696e6720736f6d65203130307320246f7264692077696c6c206265207375636820612062696720667574757265206e756d6265722e0d0a486f6c64696e67206f7468657220627263323073207370656369616c20746865206d6f7374206561726c79206f6e6365206973207375706572206269672e0d0a0d0a246f72646920746f20316b20242020202d2d20246d656d6520746f203130306b20242020202d2d20666f72206120676f6f642067726f756e6420666c6f6f722e20202d2d200d0a0d0a416c6c206f74686572206c6567656e6461727920636f696e73206f6e20626974636f696e2077696c6c20666c7920776974682074686f73652032206c6561646572732e0d0a0d0a416e642067657420616c736f206f7468657220627263323020746f6b656e7320617320744d43016869732069732061206e65772061726561206f6620636f696e732066756c6c792073746f726564206f6e2074686520626974636f696e20636861696e2e2049747320686973746f726963616c210d0a0d0a0d0a246d656d6520246f72646920746f6765746865722077697468207468652072657374206f6620746865206d6f7374206561726c7920746f702031303020627263323020636f696e7320616e6420616c6c20746865206e6577206d616465206f6e636520746f20746865206d6f6f6e3a290d0a0d0a3231206d696f20246f72646920696e206578697374656e63650d0a39396b20246d656d6520696e206578697374656e63652028366b206f66207468617420737570706c79206973206275726e656420666f726576657229200d0a0d0a737570706f727420666f722062726332307320417072696c20323320323032336821c0117f692257b2331233b5705ce9c682be8719ff1b2b64cbca290bd6faeb54423e"",""script"":"""",""index"":0,""prev_out"":{""addr"":""bc1pflrnqmv3t0dfx3ueneye0msgvjhu3e8hcmrjvumj3mtyldnzeldqvgpm6x"",""n"":0,""script"":""51204fc7306d915bda9347999e4997ee0864afc8e4f7c6c72673728ed64fb662cfda"",""spending_outpoints"":[{""n"":0,""tx_index"":6626074251895911}],""spent"":true,""tx_index"":4244231099718304,""type"":0,""value"":3000}}]","[{""type"":0,""spent"":false,""value"":546,""spending_outpoints"":[],""n"":0,""tx_index"":6626074251895911,""script"":""76a914a0b0d60e5991578ed37cbda2b17d8b2ce23ab29588ac"",""addr"":""1FeexV6bAHb8ybZjqQMjJrcCrHGW9sb6uF""},{""type"":0,""spent"":true,""value"":1332,""spending_outpoints"":[{""tx_index"":7592850279464820,""n"":0}],""n"":1,""tx_index"":6626074251895911,""script"":""0014962e45a356f60e2da9a3288cb85aabf30bf1676a"",""addr"":""bc1qjchytg6k7c8zm2dr9zxtsk4t7v9lzem22uzl4h""}]",546,7995725238307
"032e7f11ba981e2ebd9117869704c5a4571d4d47bf063086bec8ce5ad53ddb68",1,1,21,849,3066,53901,"0.0.0.0",0,3689307024611801,false,1682020112,786282,786282,"[{""sequence"":4294967295,""witness"":""02483045022100d56e101212a5dd18e021cc06e2f3ae42ca6e82246a28c66347bb1ec3569a3b2202206de27130fbc56f259cbfacc5794b95e185926a96b06f409648ce02d6eb7949360121022a51bd8200f44d72e94fa623ad6f79efb10fa6a873b5a8cf1c63b47f6301729b"",""script"":"""",""index"":0,""prev_out"":{""addr"":""bc1qprdf80adfz7aekh5nejjfrp3jksc8r929svpxk"",""n"":19,""script"":""001408da93bfad48bddcdaf49e65248c3195a1838caa"",""spending_outpoints"":[{""n"":0,""tx_index"":3689307024611801}],""spent"":true,""tx_index"":1078915159060580,""type"":0,""value"":8384712674}}]","[{""type"":0,""spent"":true,""value"":69569,""spending_outpoints"":[{""tx_index"":8305602911980493,""n"":108}],""n"":0,""tx_index"":3689307024611801,""script"":""a9144ad6df1dec0e38d552aedfe9e24f0ed17fb870ed87"",""addr"":""38WjLGya68vmnCjL6xS3a8BuFJBJV6Jwg4""},{""type"":0,""spent"":true,""value"":390000,""spending_outpoints"":[{""tx_index"":2380211898195316,""n"":1}],""n"":1,""tx_index"":3689307024611801,""script"":""76a914a41f3b776bac3a5d863e4328ea9e062227a8758688ac"",""addr"":""1FxoEX2ugSeHoy5KbWvHvaEhYLQVWhgqVC""},{""type"":0,""spent"":true,""value"":3538331,""spending_outpoints"":[{""tx_index"":6059644283741694,""n"":0}],""n"":2,""tx_index"":3689307024611801,""script"":""0014455ff282f7fc318f5718763b0bce599d8d0eac5b"",""addr"":""bc1qg40l9qhhlscc74ccwcashnjenkxsatzml03f0d""},{""type"":0,""spent"":false,""value"":9300000,""spending_outpoints"":[],""n"":3,""tx_index"":3689307024611801,""script"":""0014e20a90f9bc9b992f1d6b62e6ee18c8e0973fcc51"",""addr"":""bc1qug9fp7dunwvj78ttvtnwuxxguztnlnz35dtr2n""},{""type"":0,""spent"":true,""value"":186998,""spending_outpoints"":[{""tx_index"":1754062507258068,""n"":0}],""n"":4,""tx_index"":3689307024611801,""script"":""00144b0fbce41c9492109b61a0918f6944326c5b0dae"",""addr"":""bc1qfv8meequjjfppxmp5zgc762yxfk9krdw8dlx69""},{""type"":0,""spent"":true,""value"":707459,""spending_outpoints"":[{""tx_index"":8871826160805392,""n"":280}],""n"":5,""tx_index"":3689307024611801,""script"":""a914cadadecfcc76258f6ab821aa953983cd7272c44987"",""addr"":""3LBccfxriXJn7GNfKVkkC29XQ5TuQ4bVr9""},{""type"":0,""spent"":true,""value"":177000,""spending_outpoints"":[{""tx_index"":4819632753974140,""n"":38}],""n"":6,""tx_index"":3689307024611801,""script"":""001434d79091f3d6a5bee9224cfdd5dd39288c58550b"",""addr"":""bc1qxntepy0n66jma6fzfn7athfe9zx9s4gtph9u97""},{""type"":0,""spent"":true,""value"":348286,""spending_outpoints"":[{""tx_index"":1421604763770008,""n"":6}],""n"":7,""tx_index"":3689307024611801,""script"":""76a9143a0d8e271b671a811d274992b6f50c65598fa03988ac"",""addr"":""16HxRxuJcDdMFxcdZZAmMWMc2PgdXWNE1F""},{""type"":0,""spent"":false,""value"":8888,""spending_outpoints"":[],""n"":8,""tx_index"":3689307024611801,""script"":""76a914a0b0d60e5991578ed37cbda2b17d8b2ce23ab29588ac"",""addr"":""1FeexV6bAHb8ybZjqQMjJrcCrHGW9sb6uF""},{""type"":0,""spent"":true,""value"":1300000,""spending_outpoints"":[{""tx_index"":2832324827348832,""n"":99}],""n"":9,""tx_index"":3689307024611801,""script"":""00209619765b7852e5c8f8ab01268ba4709644256d11385558c9ee3db8383847e8d3"",""addr"":""bc1qjcvhvkmc2tju379tqynghfrsjezz2mg38p243j0w8kurswz8arfsxfjfk8""},{""type"":0,""spent"":true,""value"":85462,""spending_outpoints"":[{""tx_index"":8546498366762677,""n"":371}],""n"":10,""tx_index"":3689307024611801,""script"":""a914c222a17347a875dd7444614d749a2ec86d58f48587"",""addr"":""3KPWVwTH2V58DCAiLprAwWURAYwdCceUnf""},{""type"":0,""spent"":true,""value"":175266,""spending_outpoints"":[{""tx_index"":387645218648352,""n"":8}],""n"":11,""tx_index"":3689307024611801,""script"":""00142b96d055d27a71cff483283e644b4bcaf7cf6c38"",""addr"":""bc1q9wtdq4wj0fculayr9qlxgj6tetmu7mpckqeytf""},{""type"":0,""spent"":true,""value"":3470327,""spending_outpoints"":[{""tx_index"":5462728487230281,""n"":0}],""n"":12,""tx_index"":3689307024611801,""script"":""a914c9d794356614f63bfab98f2788c313d07656cf1987"",""addr"":""3L6FzniSvwjb4UgRHf2UiiwPSJTkSwFMuY""},{""type"":0,""spent"":true,""value"":17156548,""spending_outpoints"":[{""tx_index"":1257803905405238,""n"":2}],""n"":13,""tx_index"":3689307024611801,""script"":""00146981d5c3eea0a2b6f6f11d9dd59d3122809ae08f"",""addr"":""bc1qdxqatslw5z3tdah3rkwat8f3y2qf4cy0u50qyy""},{""type"":0,""spent"":true,""value"":131238,""spending_outpoints"":[{""tx_index"":281074050309606,""n"":95}],""n"":14,""tx_index"":3689307024611801,""script"":""76a914599f74bcd583a8986f75c2582143942ef292037088ac"",""addr"":""19AtAGgqNJhCoSaPXVHaCpvSh2xsWKuLrP""},{""type"":0,""spent"":false,""value"":286140,""spending_outpoints"":[],""n"":15,""tx_index"":3689307024611801,""script"":""76a9147e191bd52a67dd042cf49e7ae42b73c245074c3388ac"",""addr"":""1CVkDkoRkLMGPJuXSmFUfmSLF3vXD2w7oZ""},{""type"":0,""spent"":true,""value"":148786,""spending_outpoints"":[{""tx_index"":5474958387157335,""n"":1}],""n"":16,""tx_index"":3689307024611801,""script"":""a914cb23578511cc241f1c1ee3c0cb7feffac9248b4787"",""addr"":""3LD7S5hRpCkAjbWNuxm6HsXLuSmgrkZRRL""},{""type"":0,""spent"":true,""value"":257693,""spending_outpoints"":[{""tx_index"":5260708741750860,""n"":2}],""n"":17,""tx_index"":3689307024611801,""script"":""76a914669ab42a6590434766a7ec8b75577db3ae9f91f388ac"",""addr"":""1AMXFaFJrbYwx4EKsuWXJMES4xJt92cUkL""},{""type"":0,""spent"":true,""value"":527425,""spending_outpoints"":[{""tx_index"":2704599565299434,""n"":192}],""n"":18,""tx_index"":3689307024611801,""script"":""a914d04f8e172fb7e6ba9f25c842e24eac61a20e009c87"",""addr"":""3LgTn2SZL2gkozwD5UZyvi4F9q7CXQVHjk""},{""type"":0,""spent"":true,""value"":759968,""spending_outpoints"":[{""tx_index"":6665075841516766,""n"":59}],""n"":19,""tx_index"":3689307024611801,""script"":""a914e974858549f2cd6bce18a556ea77e028cc3f578f87"",""addr"":""3NyQxJPC3kgvyvXjD2UFi32v28cucbrPmo""},{""type"":0,""spent"":true,""value"":8345633389,""spending_outpoints"":[{""tx_index"":923980258879514,""n"":0}],""n"":20,""tx_index"":3689307024611801,""script"":""001408da93bfad48bddcdaf49e65248c3195a1838caa"",""addr"":""bc1qprdf80adfz7aekh5nejjfrp3jksc8r929svpxk""}]",8888,7995725237761
"9f0f8a1f1b850029e81fb08162662fe9e5d946776f0bff1e23f07645af7d1607",2,2,2,303,810,4080,"0.0.0.0",0,249381738032862,false,1681335287,785136,785136,"[{""sequence"":4294967293,""witness"":""0140168e9a1050c01845a9e350d3236a6cb5e33b0eb9a19d3c739d39742b6c999d7432ac3742c449f9f53ba47c094be8d87cb28682ba473d32bc28816e76a79784fd"",""script"":"""",""index"":0,""prev_out"":{""addr"":""bc1p27ux2686s9rjm334r9svuud7mdtyx5f4qhacgwhek6wnnja830zqlkcy7q"",""n"":0,""script"":""512057b86568fa81472dc6351960ce71bedb5643513505fb843af9b69d39cba78bc4"",""spending_outpoints"":[{""n"":0,""tx_index"":249381738032862}],""spent"":true,""tx_index"":8978802953806621,""type"":0,""value"":546}},{""sequence"":4294967293,""witness"":""01401aa748c12eab9cd633e260ba08c442d1450527193558f1063fe81da60f81ce96fe5c623b495d117398416d58093b59ea2df2433558983ca743a03be0e520822e"",""script"":"""",""index"":1,""prev_out"":{""addr"":""bc1p27ux2686s9rjm334r9svuud7mdtyx5f4qhacgwhek6wnnja830zqlkcy7q"",""n"":1,""script"":""512057b86568fa81472dc6351960ce71bedb5643513505fb843af9b69d39cba78bc4"",""spending_outpoints"":[{""n"":1,""tx_index"":249381738032862}],""spent"":true,""tx_index"":6641050252393460,""type"":0,""value"":75762}}]","[{""type"":0,""spent"":false,""value"":546,""spending_outpoints"":[],""n"":0,""tx_index"":249381738032862,""script"":""76a914a0b0d60e5991578ed37cbda2b17d8b2ce23ab29588ac"",""addr"":""1FeexV6bAHb8ybZjqQMjJrcCrHGW9sb6uF""},{""type"":0,""spent"":true,""value"":71682,""spending_outpoints"":[{""tx_index"":391660264072173,""n"":0}],""n"":1,""tx_index"":249381738032862,""script"":""512057b86568fa81472dc6351960ce71bedb5643513505fb843af9b69d39cba78bc4"",""addr"":""bc1p27ux2686s9rjm334r9svuud7mdtyx5f4qhacgwhek6wnnja830zqlkcy7q""}]",546,7995725228873
"20478b7b1567c0380950d3bacf96ba67fd2294254a81c6cb99825ae9c241cd2f",1,1,2,225,573,2736,"0.0.0.0",0,1681875779005264,false,1680719833,784081,784081,"[{""sequence"":4294967293,""witness"":""0247304402207814733adf0b5d11c06c4585ee9251dda2aa204b287816d10884fe2e7a7087300220759be05b328018d167165ba6733308713439ecda64ca97293d12fcbc088292e00121035df9cd3cc9842077815777cc5bc6638ee1b097e64c969d9342e268ff357192ce"",""script"":"""",""index"":0,""prev_out"":{""addr"":""bc1qhd9m2dhf230gwde0hpmpxyxqetqr76ksnp5p7x"",""n"":206,""script"":""0014bb4bb536e9545e87372fb8761310c0cac03f6ad0"",""spending_outpoints"":[{""n"":0,""tx_index"":1681875779005264}],""spent"":true,""tx_index"":1324241353904507,""type"":0,""value"":1173642}}]","[{""type"":0,""spent"":false,""value"":666,""spending_outpoints"":[],""n"":0,""tx_index"":1681875779005264,""script"":""76a914a0b0d60e5991578ed37cbda2b17d8b2ce23ab29588ac"",""addr"":""1FeexV6bAHb8ybZjqQMjJrcCrHGW9sb6uF""},{""type"":0,""spent"":true,""value"":1170240,""spending_outpoints"":[{""tx_index"":1644936448938436,""n"":0}],""n"":1,""tx_index"":1681875779005264,""script"":""0014e7e8ce74f0def80f5b9bd7d9d54c8cdd276f8368"",""addr"":""bc1qul5vua8smmuq7kum6lva2nyvm5nklqmganwnyf""}]",666,7995725228327
"106974d20aa3e86b14ca6f652f67dda750bf0ba0b3c387203e9fe13defd1733e",2,1,7,400,1270,15981,"0.0.0.0",0,2197349256903731,false,1680338993,783431,783431,"[{""sequence"":4294967293,""witness"":""02483045022100d97247b1bfd13b14550d8e9728d5183665f2e998ef085406b980ff67ca43d57102205777ffe7da6e9b1693f1982e91f14fbceba05474f27e4efe29b6d7d69a7b73f5012103a0f642a56cff72beebdbad0431e18b89a874d52876920934d3a2528e3b6bf4fd"",""script"":"""",""index"":0,""prev_out"":{""addr"":""bc1qupvn8vnrun72hffean5tarm4qjlyjn8seuraq2"",""n"":0,""script"":""0014e05933b263e4fcaba539ece8be8f7504be494cf0"",""spending_outpoints"":[{""n"":0,""tx_index"":2197349256903731}],""spent"":true,""tx_index"":2479878599868717,""type"":0,""value"":155844}}]","[{""type"":0,""spent"":false,""value"":12345,""spending_outpoints"":[],""n"":0,""tx_index"":2197349256903731,""script"":""76a914d4eac89d456a48d2405645c4602264961215968b88ac"",""addr"":""1LQoWist8KkaUXSPKZHNvEyfrEkPHzSsCd""},{""type"":0,""spent"":false,""value"":12345,""spending_outpoints"":[],""n"":1,""tx_index"":2197349256903731,""script"":""00204364063fac8829a931a752ecd9049e43425e2cebf83681876c556002bf389b00"",""addr"":""bc1qgdjqv0av3q56jvd82tkdjpy7gdp9ut8tlqmgrpmv24sq90ecnvqqjwvw97""},{""type"":0,""spent"":false,""value"":12345,""spending_outpoints"":[],""n"":2,""tx_index"":2197349256903731,""script"":""0014ed1d64772e536cca6ac964aa593faca4f7fad0c5"",""addr"":""bc1qa5wkgaew2dkv56kfvj49j0av5nml45x9ek9hz6""},{""type"":0,""spent"":true,""value"":67151,""spending_outpoints"":[{""tx_index"":2062754042637629,""n"":0}],""n"":3,""tx_index"":2197349256903731,""script"":""00141f8b68d0d1b9aa3efef5f5aae2d279ccee74d4c7"",""addr"":""bc1qr79k35x3hx4ralh47k4w95neenh8f4x82allf7""},{""type"":0,""spent"":true,""value"":12345,""spending_outpoints"":[{""tx_index"":4006247665773165,""n"":2}],""n"":4,""tx_index"":2197349256903731,""script"":""a914b644bb917e8ce0a83d33d549db72b30c3a8cff8787"",""addr"":""3JJmF63ifcamPLiAmLgG96RA599yNtY3EQ""},{""type"":0,""spent"":false,""value"":10987,""spending_outpoints"":[],""n"":5,""tx_index"":2197349256903731,""script"":""76a914d74de95f65799793f16b91ed8a152110652d3ec088ac"",""addr"":""1LdRcdxfbSnmCYYNdeYpUnztiYzVfBEQeC""},{""type"":0,""spent"":false,""value"":12345,""spending_outpoints"":[],""n"":6,""tx_index"":2197349256903731,""script"":""76a914a0b0d60e5991578ed37cbda2b17d8b2ce23ab29588ac"",""addr"":""1FeexV6bAHb8ybZjqQMjJrcCrHGW9sb6uF""}]",12345,7995725227661
"df735fff1a2d241f6fbd5910a141feac621479a08ac00820c183d730e3e9f79c",1,1,46,1687,6418,59994,"0.0.0.0",0,5522835034741488,false,1678854532,780872,780872,"[{""sequence"":4294967293,""witness"":""02483045022100aad0a750a24ff8ad447300944c6e82945f82c80942f9f4679cb2599f22a1218c022060fc6ad212e25ccb4ca04976a7d6217a1a6adba206a7e821eb943cc0ea09327101210246f7ec596547e4f87f29aa1650f59fd9772bb964a75c82cdec80074c767b7926"",""script"":""1600142277d7263999a2f530efd926d6d595ef7b027c3d"",""index"":0,""prev_out"":{""addr"":""3NSa5aSknNkZzw4M8iiXRcW1sjid8quXdt"",""n"":35,""script"":""a914e39f3e8aac37cf712bd65ae854c3888a9242468887"",""spending_outpoints"":[{""n"":0,""tx_index"":5522835034741488}],""spent"":true,""tx_index"":334129873416412,""type"":0,""value"":37702160}}]","[{""type"":0,""spent"":true,""value"":478280,""spending_outpoints"":[{""tx_index"":8745809165260051,""n"":1}],""n"":0,""tx_index"":5522835034741488,""script"":""001470ab6b5dbd5def16dc99fe554ea65898374a2c9f"",""addr"":""bc1qwz4kkhdathh3dhyele25afjcnqm55tylyra5pl""},{""type"":0,""spent"":true,""value"":241800,""spending_outpoints"":[{""tx_index"":2217698921652416,""n"":25}],""n"":1,""tx_index"":5522835034741488,""script"":""a914652438122176dde4c638b5635945d1ffa19bc1cf87"",""addr"":""3AuoZTg6scYa5CkkYD9iuK5fkEM2A6yt5Q""},{""type"":0,""spent"":false,""value"":7045,""spending_outpoints"":[],""n"":2,""tx_index"":5522835034741488,""script"":""76a914a0b0d60e5991578ed37cbda2b17d8b2ce23ab29588ac"",""addr"":""1FeexV6bAHb8ybZjqQMjJrcCrHGW9sb6uF""},{""type"":0,""spent"":true,""value"":80540,""spending_outpoints"":[{""tx_index"":5650129521725302,""n"":0}],""n"":3,""tx_index"":5522835034741488,""script"":""76a9147ed1093a4cf49b7928fa82a64ec3e71dc329948a88ac"",""addr"":""1CZYZFV4roRPJyGys95C6KhBSph6j9U8do""},{""type"":0,""spent"":true,""value"":140993,""spending_outpoints"":[{""tx_index"":2021963378000319,""n"":640}],""n"":4,""tx_index"":5522835034741488,""script"":""00149159cf6aaf0da95bac643fb30520e9bcebf61cdc"",""addr"":""bc1qj9vu7640pk54htry87es2g8fhn4lv8xuzqpg6s""},{""type"":0,""spent"":true,""value"":189222,""spending_outpoints"":[{""tx_index"":2859505423119362,""n"":287}],""n"":5,""tx_index"":5522835034741488,""script"":""0014917ba4e2918801b3cccafedd1885c26c88f1820d"",""addr"":""bc1qj9a6fc533qqm8nx2lmw33pwzdjy0rqsdfekksx""},{""type"":0,""spent"":true,""value"":82635,""spending_outpoints"":[{""tx_index"":7255386132892440,""n"":165}],""n"":6,""tx_index"":5522835034741488,""script"":""a914e31e4896668158190e3748d35cd7e8d22ce1112687"",""addr"":""3NPubE7NZKewuwxHqU98pDkUWwdZMt27HP""},{""type"":0,""spent"":true,""value"":8048000,""spending_outpoints"":[{""tx_index"":7765594160401604,""n"":1}],""n"":7,""tx_index"":5522835034741488,""script"":""76a9146b57414faf6a2cd8720df6e4856ae3b438a1b95488ac"",""addr"":""1AnZq7r3LdnRX5vCicSCsvhUeBTcyutSGa""},{""type"":0,""spent"":true,""value"":200000,""spending_outpoints"":[{""tx_index"":8926752694045506,""n"":0}],""n"":8,""tx_index"":5522835034741488,""script"":""0014707a0b7fd729d8b25886c0867a30bbb202d34946"",""addr"":""bc1qwpaqkl7h98vtykyxczr85v9mkgpdxj2xsqrcqu""},{""type"":0,""spent"":true,""value"":33978,""spending_outpoints"":[{""tx_index"":5545996441837652,""n"":344}],""n"":9,""tx_index"":5522835034741488,""script"":""a9144dbceebb2532b6818e02f0863ecb5305de6e1a4887"",""addr"":""38n4HaUQKAmjxEF5yrnk1uUFMo5qVjh2d6""},{""type"":0,""spent"":true,""value"":1851500,""spending_outpoints"":[{""tx_index"":3066405430874074,""n"":56}],""n"":10,""tx_index"":5522835034741488,""script"":""a9148fed9736a34750a91464a007b20feb361f0d064787"",""addr"":""3Ep3B4jX1f8r1XR3c9Nn9n6iCEoM7BT1wE""},{""type"":0,""spent"":true,""value"":80600,""spending_outpoints"":[{""tx_index"":8315768213377443,""n"":103}],""n"":11,""tx_index"":5522835034741488,""script"":""a914933aca51407f07683412e9d2d9118d41ff2ff30987"",""addr"":""3F7VgZhhyzWWfZWu85Q7F2fEmUbJtcYZMd""},{""type"":0,""spent"":true,""value"":31940,""spending_outpoints"":[{""tx_index"":6170330288072459,""n"":3}],""n"":12,""tx_index"":5522835034741488,""script"":""76a914f70d65bcafc90b7ea6a27f62c3c467979298be4b88ac"",""addr"":""1PXHxFXhjvwwvDayd8grsCRzocWdSWFjak""},{""type"":0,""spent"":true,""value"":178617,""spending_outpoints"":[{""tx_index"":8539008510407030,""n"":2}],""n"":13,""tx_index"":5522835034741488,""script"":""76a91490de59057a8ded479ec016a2ebda944d89a5c9cf88ac"",""addr"":""1ECzfch9q9R5X1mEv1rwJgF9KrY8JLP6w6""},{""type"":0,""spent"":true,""value"":2880455,""spending_outpoints"":[{""tx_index"":3417306409245409,""n"":914}],""n"":14,""tx_index"":5522835034741488,""script"":""a914bcec5c9e57b1712c64f5f4b6755ec6f1e36f969387"",""addr"":""3Jux7K7HKxSJ7i4xPLKmH38Kn1TJNRCaEA""},{""type"":0,""spent"":true,""value"":965829,""spending_outpoints"":[{""tx_index"":789092966477300,""n"":594}],""n"":15,""tx_index"":5522835034741488,""script"":""a91415a83fed792b343ecaa3189d809481963bcac7fa87"",""addr"":""33fXfmU6vWbjwc3wnKJU65mxuyv6p7cNRa""},{""type"":0,""spent"":true,""value"":28000,""spending_outpoints"":[{""tx_index"":2092262259609993,""n"":351}],""n"":16,""tx_index"":5522835034741488,""script"":""76a91499caa984d57477a23a49e59542071340ab57c5c088ac"",""addr"":""1F2BAZo13jdt4wgbT5gZ1RtziF3SWZ11XU""},{""type"":0,""spent"":true,""value"":572402,""spending_outpoints"":[{""tx_index"":3417306409245409,""n"":86}],""n"":17,""tx_index"":5522835034741488,""script"":""a9149f00e5fcf2a5ffa43581d26dde5d108fd7f0c4ab87"",""addr"":""3GBkSTzAjH2K2CgoHRsyv3LhiCuzME9k1r""},{""type"":0,""spent"":true,""value"":364017,""spending_outpoints"":[{""tx_index"":3750565113631845,""n"":214}],""n"":18,""tx_index"":5522835034741488,""script"":""a914ed180a1239b1941742bf066e2c2ec909cede32a887"",""addr"":""3PJesHnb1Lf7cgk1MqRdozYrJBGwKudmk7""},{""type"":0,""spent"":true,""value"":977839,""spending_outpoints"":[{""tx_index"":1573081175272021,""n"":141}],""n"":19,""tx_index"":5522835034741488,""script"":""00147b0dbc4a0ea32b0e1ff6239659f6ca0e393ca1c8"",""addr"":""bc1q0vxmcjsw5v4su8lkywt9nak2pcunegwglgnja9""},{""type"":0,""spent"":true,""value"":287493,""spending_outpoints"":[{""tx_index"":1515946425409435,""n"":833}],""n"":20,""tx_index"":5522835034741488,""script"":""a914acf4ee5d2d62fc7f98aa97a065a9403c15674e4187"",""addr"":""3HTXZegDddHsDWmi7FESynQ78MUb4ernKg""},{""type"":0,""spent"":true,""value"":124961,""spending_outpoints"":[{""tx_index"":7823385578473140,""n"":98}],""n"":21,""tx_index"":5522835034741488,""script"":""a9146a36566cd6e9dab09b196dcc7924aec308e0e52687"",""addr"":""3BNceKXiikvSr2YPNwYpuGLPM4p98Wo5eG""},{""type"":0,""spent"":true,""value"":80623,""spending_outpoints"":[{""tx_index"":2839825612509368,""n"":1}],""n"":22,""tx_index"":5522835034741488,""script"":""00140be1815983e513fc3f8d266e35f1c550fae0f53c"",""addr"":""bc1qp0sczkvru5flc0udyehrtuw92rawpafuzy7fn9""},{""type"":0,""spent"":true,""value"":45094,""spending_outpoints"":[{""tx_index"":2240623568796456,""n"":29}],""n"":23,""tx_index"":5522835034741488,""script"":""76a914edb110df0afe747ac9917b858789103e0020bda588ac"",""addr"":""1NfoGDftbKL3PGH9z6khcw15QC3FZ3jUZD""},{""type"":0,""spent"":true,""value"":1098825,""spending_outpoints"":[{""tx_index"":5889179736672633,""n"":256}],""n"":24,""tx_index"":5522835034741488,""script"":""a9140832cd8945df822b732ae80a5e824ae6a9e3bc5987"",""addr"":""32SNBvYufBiYRuEv92rMxkGuHv5VyV25Tm""},{""type"":0,""spent"":true,""value"":47525,""spending_outpoints"":[{""tx_index"":5378511150232573,""n"":442}],""n"":25,""tx_index"":5522835034741488,""script"":""0014fd8538390548c9e845f8514bb80356e71b013eef"",""addr"":""bc1qlkznswg9fry7s30c299msq6kuudsz0h0cae9cs""},{""type"":0,""spent"":true,""value"":84631,""spending_outpoints"":[{""tx_index"":7255386132892440,""n"":218}],""n"":26,""tx_index"":5522835034741488,""script"":""a914bf374856f68c071f7c731a5246bc35472ec0bf4587"",""addr"":""3K85DHS8eLUZuyJGC48k3iDNKwH52tdCGJ""},{""type"":0,""spent"":true,""value"":109437,""spending_outpoints"":[{""tx_index"":6037688064885405,""n"":0}],""n"":27,""tx_index"":5522835034741488,""script"":""0014a32b73bee640d49ade4270dbdebe5b44997bcb3c"",""addr"":""bc1q5v4h80hxgr2f4hjzwrdaa0jmgjvhhjeuchfsyr""},{""type"":0,""spent"":true,""value"":374325,""spending_outpoints"":[{""tx_index"":6262969103831043,""n"":16}],""n"":28,""tx_index"":5522835034741488,""script"":""76a9146874632266e0f720e1600ef15aaaddef3b19a09488ac"",""addr"":""1AXJhgKCgdCkZH2MmyQ7SPsbZfZp82vU38""},{""type"":0,""spent"":true,""value"":192845,""spending_outpoints"":[{""tx_index"":22444217494323,""n"":11}],""n"":29,""tx_index"":5522835034741488,""script"":""76a9141a4ad87fc7abd3425a39c66daf53ff5e0377f07888ac"",""addr"":""13Q2EMmF5BUsiV45jmvZRQ79EaJRHrC58a""},{""type"":0,""spent"":true,""value"":1704690,""spending_outpoints"":[{""tx_index"":7623800017271666,""n"":55}],""n"":30,""tx_index"":5522835034741488,""script"":""00201295b8fd2c7bd506e7c25aede5a312d4f1cba779573184488570a7a69e272dca"",""addr"":""bc1qz22m3lfv002sde7zttk7tgcj6ncuhfme2uccgjy9wzn6d8389h9q6gvxt3""},{""type"":0,""spent"":true,""value"":696026,""spending_outpoints"":[{""tx_index"":350775400170658,""n"":0}],""n"":31,""tx_index"":5522835034741488,""script"":""0014ed780b92d17501b1d7570c80cdf817dadd2fcac8"",""addr"":""bc1qa4uqhyk3w5qmr46hpjqvm7qhmtwjljkgnuwnxy""},{""type"":0,""spent"":true,""value"":210000,""spending_outpoints"":[{""tx_index"":3762877527238195,""n"":139}],""n"":32,""tx_index"":5522835034741488,""script"":""a91440abbc442aa6ab132ea3525b60cdaf4d807d317887"",""addr"":""37axuCwhpKk23c8MALxRie1eo9fMKNAD2B""},{""type"":0,""spent"":true,""value"":2418600,""spending_outpoints"":[{""tx_index"":3314987817368003,""n"":241}],""n"":33,""tx_index"":5522835034741488,""script"":""a91456e16129f61e8fa78f0634da889a676ca5fab19387"",""addr"":""39cQ2gmxYtHNkkeY5jAwRVvvHNiNnSFzeH""},{""type"":0,""spent"":false,""value"":19000,""spending_outpoints"":[],""n"":34,""tx_index"":5522835034741488,""script"":""001450d214ac76651ab92c1bdc4e994a063d43556f4b"",""addr"":""bc1q2rfpftrkv5dtjtqmm38fjjsx84p42m6ty33ehn""},{""type"":0,""spent"":true,""value"":1519687,""spending_outpoints"":[{""tx_index"":567463409395782,""n"":86}],""n"":35,""tx_index"":5522835034741488,""script"":""0020d7b194d7726f15a0c3e91be1c1fb00496d5a3db78308b883b72ddace4aca2c4c"",""addr"":""bc1q67cef4mjdu26pslfr0sur7cqf9k450dhsvyt3qah9hdvujk293xqpznt32""},{""type"":0,""spent"":true,""value"":163956,""spending_outpoints"":[{""tx_index"":7844983844962792,""n"":84}],""n"":36,""tx_index"":5522835034741488,""script"":""a9143ed7ab0c29fc320320ac05bfd92cbbe72747e84487"",""addr"":""37RJBKhro58DEg8KTPp1JVcqRFnzDVwzfn""},{""type"":0,""spent"":true,""value"":749766,""spending_outpoints"":[{""tx_index"":5398766508618595,""n"":2}],""n"":37,""tx_index"":5522835034741488,""script"":""00147484fcf3247cd503c88f18080d4b15f7f051b5d0"",""addr"":""bc1qwjz0euey0n2s8jy0rqyq6jc47lc9rdwsh7awhd""},{""type"":0,""spent"":true,""value"":80480,""spending_outpoints"":[{""tx_index"":1229387091254475,""n"":191}],""n"":38,""tx_index"":5522835034741488,""script"":""a914b729cbc66bdf2a7b7581781fe96eb23a488a63da87"",""addr"":""3JPVegi9irREq6JgUJ6ReomMawQJhE1VzC""},{""type"":0,""spent"":true,""value"":225736,""spending_outpoints"":[{""tx_index"":263955677265437,""n"":486}],""n"":39,""tx_index"":5522835034741488,""script"":""a914badc093ce03bc407aa626ac17ec9dac1af19e6be87"",""addr"":""3Jj3CbijoKhaT1X9pZx98tYMkNr21Hwx4n""},{""type"":0,""spent"":true,""value"":181350,""spending_outpoints"":[{""tx_index"":8470773421107187,""n"":399}],""n"":40,""tx_index"":5522835034741488,""script"":""a914dbe894917488eaedef73ca4753912c445dadb29487"",""addr"":""3MjnXX8PDBatLYHToMd15Luz9vQh5h4jFD""},{""type"":0,""spent"":false,""value"":1271900,""spending_outpoints"":[],""n"":41,""tx_index"":5522835034741488,""script"":""76a914dce2b1a5db594d303593844b7e950826fea3ad8b88ac"",""addr"":""1M8wEB4tZSmCwTMBrPkiBzem1oAeWxsgFj""},{""type"":0,""spent"":true,""value"":94728,""spending_outpoints"":[{""tx_index"":5066514660825656,""n"":55}],""n"":42,""tx_index"":5522835034741488,""script"":""76a91429329ff6bf695795671d2319cebd6943b9cff8dc88ac"",""addr"":""14kqMLqAVpKrAaAsZc4fxWT1u7U2jMqcqj""},{""type"":0,""spent"":true,""value"":40328,""spending_outpoints"":[{""tx_index"":1060204230665860,""n"":48}],""n"":43,""tx_index"":5522835034741488,""script"":""0014b0a738cc228aab3faaa842f89674ed5bd0f44f1d"",""addr"":""bc1qkznn3npz324nl24ggtufva8dt0g0gncaastf3d""},{""type"":0,""spent"":true,""value"":122725,""spending_outpoints"":[{""tx_index"":7905336108164619,""n"":0}],""n"":44,""tx_index"":5522835034741488,""script"":""001446124a7e244f206d6f08c5adf7fd8f7b8e953fbf"",""addr"":""bc1qgcfy5l3yfusx6mcgckkl0lv00w8f20al64z4xc""},{""type"":0,""spent"":true,""value"":8263743,""spending_outpoints"":[{""tx_index"":2376435439475191,""n"":3}],""n"":45,""tx_index"":5522835034741488,""script"":""a914c9003dd968df7175c44163ea9b933e785a39dc8e87"",""addr"":""3L1p2tUHPwrRN3qgf4Hm1R73e29hFshbnp""}]",7045,7995725215316
"11061faec0132cb962068ece55ee1289271e2cacd503f5f25c8628b38c7f0051",2,1,8,414,1656,661,"0.0.0.0",777347,2850002616870160,false,1676815825,777351,777351,"[{""sequence"":4294967293,""witness"":"""",""script"":""47304402202d86e0c5dfdaae5e0567abbdf5653b783e825634de4583f178c75decc8b1aff602205adb4089ff06270b5fc447df88eb8bc48f0a7ce237054f1e8cd926a8f309694d01210302bf5908a3875c6854ffab2b875c3eb8eae903f8998a06c10ff8031947da5d38"",""index"":0,""prev_out"":{""addr"":""1BJtd9prmLo3vYN3wcs8fBTHxeqoZAtQXP"",""n"":1,""script"":""76a91471136c12a9fdcf1db20ab435d50271ded80790c888ac"",""spending_outpoints"":[{""n"":0,""tx_index"":2850002616870160}],""spent"":true,""tx_index"":8617807613370747,""type"":0,""value"":657207}}]","[{""type"":0,""spent"":true,""value"":7873,""spending_outpoints"":[{""tx_index"":4396017496942696,""n"":21}],""n"":0,""tx_index"":2850002616870160,""script"":""76a9142bc1c5430ed033fe0d6f07f40cf714750520a90788ac"",""addr"":""14zNBfSsP1WDUZkz1ky8ZD9GZUc88nNZLG""},{""type"":0,""spent"":true,""value"":21967,""spending_outpoints"":[{""tx_index"":1197478818757494,""n"":35}],""n"":1,""tx_index"":2850002616870160,""script"":""00149b0608f6bf0421eb59842620e80ca937232fe1f8"",""addr"":""bc1qnvrq3a4lqss7kkvyycswsr9fxu3jlc0c79wr0m""},{""type"":0,""spent"":true,""value"":81787,""spending_outpoints"":[{""tx_index"":8902974501950488,""n"":35}],""n"":2,""tx_index"":2850002616870160,""script"":""001459f9be90cc6aa6788928807fe3e493e8db917fa8"",""addr"":""bc1qt8umayxvd2n83zfgspl78eynardezlags3q29s""},{""type"":0,""spent"":false,""value"":5702,""spending_outpoints"":[],""n"":3,""tx_index"":2850002616870160,""script"":""001443b263578410385b380b98a788bb1cda3968a5ce"",""addr"":""bc1qgwexx4uyzqu9kwqtnznc3wcumguk3fww093423""},{""type"":0,""spent"":true,""value"":17111,""spending_outpoints"":[{""tx_index"":5663318000903987,""n"":2}],""n"":4,""tx_index"":2850002616870160,""script"":""001433b5e73efb528d178c2dfee6fd9e11e2f27de65b"",""addr"":""bc1qxw67w0hm22x30rpdlmn0m8s3ute8mejmw9gwk4""},{""type"":0,""spent"":true,""value"":518066,""spending_outpoints"":[{""tx_index"":2395604484744492,""n"":1}],""n"":5,""tx_index"":2850002616870160,""script"":""76a914a942dc617bf8b86cfeb0207f67b0ed8e2d9646bf88ac"",""addr"":""1GRyHzdAaJASJDrjJgcfriyqXq34dtbmHJ""},{""type"":0,""spent"":false,""value"":1972,""spending_outpoints"":[],""n"":6,""tx_index"":2850002616870160,""script"":""76a914a0b0d60e5991578ed37cbda2b17d8b2ce23ab29588ac"",""addr"":""1FeexV6bAHb8ybZjqQMjJrcCrHGW9sb6uF""},{""type"":0,""spent"":true,""value"":2068,""spending_outpoints"":[{""tx_index"":999716313618549,""n"":28}],""n"":7,""tx_index"":2850002616870160,""script"":""0014cb7d7e08d86c495ab51bc39f96dfa5a467803d4d"",""addr"":""bc1qed7huzxcd3y44dgmcw0edha953ncq02dfvx2rp""}]",1972,7995725208271
"9975c3e2d84536f41fc6a26a80576acc9a797a1961a23dd50ab7095dd090ad64",2,1,2,225,573,1440,"0.0.0.0",776805,3542291894214966,false,1676539876,776806,776806,"[{""sequence"":4294967293,""witness"":""02473044022051e1c5a98d60ae9f18e7088322e2358a12f9cf109f75889eb4bc23cb68f046f40220792536ebbb2f507e5f7ef105d14f554712cc101dfcbe9b1666f5624b6da3ed5c01210363159b3d1b1e0409beade55a5f275a2d79afe68e5387bf56bba39dc8d91e464d"",""script"":"""",""index"":0,""prev_out"":{""addr"":""bc1q7pujzp3m4h6am0xg2ncqczend8ypl2ze8rc9e3"",""n"":1,""script"":""0014f07921063badf5ddbcc854f00c0b3369c81fa859"",""spending_outpoints"":[{""n"":0,""tx_index"":3542291894214966}],""spent"":true,""tx_index"":2351405078138906,""type"":0,""value"":16254}}]","[{""type"":0,""spent"":false,""value"":547,""spending_outpoints"":[],""n"":0,""tx_index"":3542291894214966,""script"":""76a914a0b0d60e5991578ed37cbda2b17d8b2ce23ab29588ac"",""addr"":""1FeexV6bAHb8ybZjqQMjJrcCrHGW9sb6uF""},{""type"":0,""spent"":true,""value"":14267,""spending_outpoints"":[{""tx_index"":2273542833262793,""n"":0}],""n"":1,""tx_index"":3542291894214966,""script"":""0014de3fdf45b4ab9764d7a94af0be5ae9a28c7b405a"",""addr"":""bc1qmcla73d54wtkf4afftctukhf52x8ksz65eqpff""}]",547,7995725206299
"29f89fae692438580c435937e8c6b276d0c343fb93bd1336c8011076e1becafd",2,1,2,225,573,1440,"0.0.0.0",776371,8929511285375488,false,1676308732,776373,776373,"[{""sequence"":4294967293,""witness"":""0247304402201af942b66e2c1a3d3a1f5f0dfdd2d6fd40a81b77d4194f7fa3cddeeb3c2d1791022032595240888899aaff602766d40a541e7e3a85abb51f7903e16a416bdee5d5ec012103ff672cc27e63dd3c87c7222a63afa9aecf07445f4ca3657389cb472248205c37"",""script"":"""",""index"":0,""prev_out"":{""addr"":""bc1qkld2mdj9g8fmngj05pv77e0xgz290jrudxckez"",""n"":1,""script"":""0014b7daadb64541d3b9a24fa059ef65e6409457c87c"",""spending_outpoints"":[{""n"":0,""tx_index"":8929511285375488}],""spent"":true,""tx_index"":6467130845303823,""type"":0,""value"":56074}}]","[{""type"":0,""spent"":false,""value"":547,""spending_outpoints"":[],""n"":0,""tx_index"":8929511285375488,""script"":""76a914a0b0d60e5991578ed37cbda2b17d8b2ce23ab29588ac"",""addr"":""1FeexV6bAHb8ybZjqQMjJrcCrHGW9sb6uF""},{""type"":0,""spent"":true,""value"":54087,""spending_outpoints"":[{""tx_index"":4812349582102912,""n"":0}],""n"":1,""tx_index"":8929511285375488,""script"":""00144b1320eea35ca35d025fe6bf9976c37920e04ef2"",""addr"":""bc1qfvfjpm4rtj346qjlu6lejakr0yswqnhjy7dgle""}]",547,7995725205752
"5d062d4f22b583efef181b774a57cc4f33023ebbeeb5b41e074e79fa9f1e0f91",2,1,2,225,573,1440,"0.0.0.0",776068,5103811978809129,false,1676140357,776069,776069,"[{""sequence"":4294967293,""witness"":""024730440220222630ca4fbf35075b413b11cadcf380e8cfd85e10a7a43f798cf01f60f4cb6b022034e047a66e3258693a521b7a259412a60d59e71871296bc2b942b8acb37a282d01210394b858aed7bf5214b5007da85fee90eda54847d39e6e390161beed65fd7696e7"",""script"":"""",""index"":0,""prev_out"":{""addr"":""bc1qut9ek7yc4l0hzj0v8fs7gnwfekqn3dwpumyxr0"",""n"":1,""script"":""0014e2cb9b7898afdf7149ec3a61e44dc9cd8138b5c1"",""spending_outpoints"":[{""n"":0,""tx_index"":5103811978809129}],""spent"":true,""tx_index"":6101362694008059,""type"":0,""value"":87896}}]","[{""type"":0,""spent"":false,""value"":547,""spending_outpoints"":[],""n"":0,""tx_index"":5103811978809129,""script"":""76a914a0b0d60e5991578ed37cbda2b17d8b2ce23ab29588ac"",""addr"":""1FeexV6bAHb8ybZjqQMjJrcCrHGW9sb6uF""},{""type"":0,""spent"":true,""value"":85909,""spending_outpoints"":[{""tx_index"":6906797904710881,""n"":0}],""n"":1,""tx_index"":5103811978809129,""script"":""0014866a14b9600534366056604b127181e071000c45"",""addr"":""bc1qse4pfwtqq56rvczkvp93yuvpupcsqrz9c2msfq""}]",547,7995725205205
"0fb619e114eaefffb6b1660ca19422154b36ee9e59f46470a798aaf3b1623831",2,1,2,225,573,2736,"0.0.0.0",775873,1731783800288595,false,1676057567,775933,775933,"[{""sequence"":4294967293,""witness"":""024730440220053a50cbd30e855b5779634e0f5bc0965f428c8828163fa27110a64ddb34e26802206ed7833ed3fea43f2624e3e10e4f01b9690ff65ea8da9ef069e02084c5ccff88012102b68c24702a7d36c572e0a28ddebdb8c5e48a5ef1d3ce7cacb524fdc2a9b8f3b1"",""script"":"""",""index"":0,""prev_out"":{""addr"":""bc1quhdnp2sqrqwrg74e5w60dpj8zzclnkllew5mfr"",""n"":1,""script"":""0014e5db30aa00181c347ab9a3b4f6864710b1f9dbff"",""spending_outpoints"":[{""n"":0,""tx_index"":1731783800288595}],""spent"":true,""tx_index"":7230022451161726,""type"":0,""value"":18237}}]","[{""type"":0,""spent"":false,""value"":777,""spending_outpoints"":[],""n"":0,""tx_index"":1731783800288595,""script"":""76a914a0b0d60e5991578ed37cbda2b17d8b2ce23ab29588ac"",""addr"":""1FeexV6bAHb8ybZjqQMjJrcCrHGW9sb6uF""},{""type"":0,""spent"":true,""value"":14724,""spending_outpoints"":[{""tx_index"":446689641893535,""n"":0}],""n"":1,""tx_index"":1731783800288595,""script"":""0014ef14235109c0eb790120b36a3cc18c39d1b8317f"",""addr"":""bc1qau2zx5gfcr4hjqfqkd4resvv88gmsvtlqmfy6f""}]",777,7995725204658
"54d46ee74ab417cdbf7cd4e62c1fdbe2d91321c84c9ff23475f3c81fe1f80ece",2,1,27,1177,3940,16368,"0.0.0.0",0,7250038411753758,false,1676035701,775885,775885,"[{""sequence"":4294967293,""witness"":""0400483045022100a51c583fd565cab8bd88d7dad8b97474be372ed4e23ab05784ec670453637a1b0220579a0903c371ec0f1b296d5f4409278a57d85bf8efff33b9fa495ac63d5fd6d401483045022100e6598e75410c193f09a4bf834a65df0cd5f3e7f8bac08c922e794fb14bdf29f70220147590512a3b7cf757743727a3d6f85e341cc8d0e40d27cfcd3aae4c43dba5ed0169522103f6f32e9463bb250d437d422f4207114b4be9d4cbf051e6348efcc36fc90c328e2102c2330d778f058f59e1a1f147686a8f8803a7df1b63ac63f9a787ad20ff8d446121027bb9f343c61d4cbfcf9a679dd45b393bb32e35b4ecefe3e543ae82140503605e53ae"",""script"":"""",""index"":0,""prev_out"":{""addr"":""bc1qpm9rlx3kpy8n0q077h4llym6mvc76agkwpf8fgykxedt8ww4f9uqfjfdp3"",""n"":23,""script"":""00200eca3f9a36090f3781fef5ebff937adb31ed7516705274a096365ab3b9d54978"",""spending_outpoints"":[{""n"":0,""tx_index"":7250038411753758}],""spent"":true,""tx_index"":3152085512756839,""type"":0,""value"":6406102939}}]","[{""type"":0,""spent"":true,""value"":2146756,""spending_outpoints"":[{""tx_index"":2300185418211803,""n"":2}],""n"":0,""tx_index"":7250038411753758,""script"":""76a9141c37f6b085a6a3633840d4f85a16098366f25e3a88ac"",""addr"":""13aCxnxysecTBcAyGBFFVxQbZGGSdAobb4""},{""type"":0,""spent"":true,""value"":4789117,""spending_outpoints"":[{""tx_index"":7358061132348449,""n"":69}],""n"":1,""tx_index"":7250038411753758,""script"":""a914816c63bf43d81f2c3d4c29e9b1c65b026f17b69b87"",""addr"":""3DVLwLKVbmaX8zXT1CqMyuWjjA83vofajU""},{""type"":0,""spent"":false,""value"":194000,""spending_outpoints"":[],""n"":2,""tx_index"":7250038411753758,""script"":""a91433c3b09cefdf83cc81f71c3f235e4d501356be5087"",""addr"":""36Qip6iUrhiBf1nLjydpvyBLP3sfMcLnrk""},{""type"":0,""spent"":true,""value"":397000,""spending_outpoints"":[{""tx_index"":5537877598293514,""n"":4}],""n"":3,""tx_index"":7250038411753758,""script"":""00149d94f54936dda1a6053c071b10404a3c31ca4390"",""addr"":""bc1qnk202jfkmks6vpfuqud3qsz28scu5sush55r9w""},{""type"":0,""spent"":true,""value"":18329000,""spending_outpoints"":[{""tx_index"":3060482487789570,""n"":3}],""n"":4,""tx_index"":7250038411753758,""script"":""a914fd7bbbc37717585ab87dcc227c9e2e4e74a4a3cc87"",""addr"":""3QoK7EATQZxtvZFs198dcZQMbaL35wmg9h""},{""type"":0,""spent"":true,""value"":3856000,""spending_outpoints"":[{""tx_index"":6975380589797236,""n"":0}],""n"":5,""tx_index"":7250038411753758,""script"":""001443cab769b6084c94321162298fabaf4aedfdc7c7"",""addr"":""bc1qg09tw6dkppxfgvs3vg5cl2a0ftklm378rkgxz9""},{""type"":0,""spent"":true,""value"":1627000,""spending_outpoints"":[{""tx_index"":3469449591628502,""n"":1}],""n"":6,""tx_index"":7250038411753758,""script"":""001435e1c3af274330f4872435841f1621b6ce87b4c6"",""addr"":""bc1qxhsu8te8gvc0fpeyxkzp793pkm8g0dxx34wx68""},{""type"":0,""spent"":true,""value"":1959000,""spending_outpoints"":[{""tx_index"":7214634366649947,""n"":3}],""n"":7,""tx_index"":7250038411753758,""script"":""00140a39af0c801a15b64a168ff9c36ea2ce08327331"",""addr"":""bc1qpgu67ryqrg2mvjsk3luuxm4zecyryue3fv5gv9""},{""type"":0,""spent"":true,""value"":5004500,""spending_outpoints"":[{""tx_index"":3914149133960863,""n"":6}],""n"":8,""tx_index"":7250038411753758,""script"":""a9141cb82002cd79b527d1357cbbcaaa035176f79f3387"",""addr"":""34JsR9VdKctriNxD21K4JhhqEWqCx1LAUY""},{""type"":0,""spent"":true,""value"":214000,""spending_outpoints"":[{""tx_index"":7376206390751249,""n"":1}],""n"":9,""tx_index"":7250038411753758,""script"":""00140e6499558410a66777fff951d46fe280c4b8174d"",""addr"":""bc1qpejfj4vyzznxwalll9gagmlzsrzts96d4fruec""},{""type"":0,""spent"":true,""value"":4829000,""spending_outpoints"":[{""tx_index"":3578423762915501,""n"":0}],""n"":10,""tx_index"":7250038411753758,""script"":""0014b697dba4479a94196d1da8bf8e166e0eff6c02e9"",""addr"":""bc1qk6tahfz8n22pjmga4zlcu9nwpmlkcqhf2jlfyj""},{""type"":0,""spent"":true,""value"":8000000,""spending_outpoints"":[{""tx_index"":1483098844659818,""n"":0}],""n"":11,""tx_index"":7250038411753758,""script"":""001469538f36adc7280d3b1b5fde750f8312fcaca867"",""addr"":""bc1qd9fc7d4dcu5q6wcmtl082rurzt72e2r8u2vh4h""},{""type"":0,""spent"":true,""value"":5068000,""spending_outpoints"":[{""tx_index"":3578423762915501,""n"":1}],""n"":12,""tx_index"":7250038411753758,""script"":""76a914f9cb9643c501be10f1a39ff5b3134ef02229cec988ac"",""addr"":""1Pmo9Eik74tqk2GFYUYsrfg4bxQt4WGAm8""},{""type"":0,""spent"":false,""value"":55000,""spending_outpoints"":[],""n"":13,""tx_index"":7250038411753758,""script"":""76a914a0b0d60e5991578ed37cbda2b17d8b2ce23ab29588ac"",""addr"":""1FeexV6bAHb8ybZjqQMjJrcCrHGW9sb6uF""},{""type"":0,""spent"":true,""value"":2208000,""spending_outpoints"":[{""tx_index"":4986773989044150,""n"":2}],""n"":14,""tx_index"":7250038411753758,""script"":""76a914162f9d9fceb5a7bb34efaf3e10a474e6439b535b88ac"",""addr"":""132JucsYy8XpQq6s5PYNZqVESnDzFKEnqX""},{""type"":0,""spent"":true,""value"":353000,""spending_outpoints"":[{""tx_index"":4073451399517881,""n"":0}],""n"":15,""tx_index"":7250038411753758,""script"":""00142d42501fd1c464fafc056884e94089df00571207"",""addr"":""bc1q94p9q873c3j04lq9dzzwjsyfmuq9wys8h9rzmh""},{""type"":0,""spent"":false,""value"":2464000,""spending_outpoints"":[],""n"":16,""tx_index"":7250038411753758,""script"":""0014794eeaeb356fed17ccd7e943763611d0fe956108"",""addr"":""bc1q098w46e4dlk30nxha9phvds36rlf2cggumvjez""},{""type"":0,""spent"":true,""value"":29999000,""spending_outpoints"":[{""tx_index"":1581764040598125,""n"":1}],""n"":17,""tx_index"":7250038411753758,""script"":""a9140f6f4426c032dbd0967cd1a3fc73c19195df7f1787"",""addr"":""336dMLHyjpG8Wt3oNMs7JLssSYfuUegnBw""},{""type"":0,""spent"":true,""value"":1006000,""spending_outpoints"":[{""tx_index"":5890046909525129,""n"":0}],""n"":18,""tx_index"":7250038411753758,""script"":""0014c9471f37bc71cd82fbc0264d4461390d8fadf59e"",""addr"":""bc1qe9r37dauw8xc977qyex5gcfepk86mav7lm3u8v""},{""type"":0,""spent"":true,""value"":965000,""spending_outpoints"":[{""tx_index"":3552877020238551,""n"":0}],""n"":19,""tx_index"":7250038411753758,""script"":""0014c7e0b557094920f099aa6052f63cd2389fe1b468"",""addr"":""bc1qclst24cffys0pxd2vpf0v0xj8z07rdrgy40wr0""},{""type"":0,""spent"":true,""value"":111776000,""spending_outpoints"":[{""tx_index"":1231577678874636,""n"":1}],""n"":20,""tx_index"":7250038411753758,""script"":""0014851bd065cded913047e993714bea51a319403ab5"",""addr"":""bc1qs5daqewdakgnq3lfjdc5h6j35vv5qw44svwwnj""},{""type"":0,""spent"":true,""value"":155000,""spending_outpoints"":[{""tx_index"":2971677412303567,""n"":228}],""n"":21,""tx_index"":7250038411753758,""script"":""a9148ae3a0f341f2057bc4da9a0cf39e7013fe3ffb4787"",""addr"":""3EMPrwGi2mnLjt1CmiK23S1ABrzgV7Q8C4""},{""type"":0,""spent"":true,""value"":736000,""spending_outpoints"":[{""tx_index"":7336700530386133,""n"":0}],""n"":22,""tx_index"":7250038411753758,""script"":""a9148dc41c41bbaa246e989baccdfedb3c5daffea9bf87"",""addr"":""3Ecc8aaexuBwYcP4kQZ1ghXLqzxfoFVsXX""},{""type"":0,""spent"":true,""value"":12243000,""spending_outpoints"":[{""tx_index"":3060482487789570,""n"":4}],""n"":23,""tx_index"":7250038411753758,""script"":""a9144967fe0884296c85ad78e4c623d02aed4ce84a4987"",""addr"":""38P9q4Syb2PtT759brdXmUHbGiNkjTFgdZ""},{""type"":0,""spent"":true,""value"":500375,""spending_outpoints"":[{""tx_index"":7259984688783020,""n"":426}],""n"":24,""tx_index"":7250038411753758,""script"":""0014fd70c92e375679511594de7e57a9fce5249b8fff"",""addr"":""bc1ql4cvjt3h2eu4z9v5mel9020uu5jfhrlldnagru""},{""type"":0,""spent"":true,""value"":3390000,""spending_outpoints"":[{""tx_index"":3710808335979438,""n"":1}],""n"":25,""tx_index"":7250038411753758,""script"":""a9143387ebf3803bf432910bbbed80fa27aaf3aa5e6687"",""addr"":""36PVDLAiyxErYU49L4zVKRTR9kqcYemh5b""},{""type"":0,""spent"":true,""value"":6183822823,""spending_outpoints"":[{""tx_index"":560214780428364,""n"":0}],""n"":26,""tx_index"":7250038411753758,""script"":""002056616f1e14197a36470fbc1b98b12dd2936b2fb8e8715181e5065a0f276bc4ca"",""addr"":""bc1q2esk78s5r9arv3c0hsde3vfd62fkktacapc4rq09qedq7fmtcn9qj3vqwj""}]",55000,7995725203881
"5167232a71a7ce1e28d1562f26f540dae4aca27ee9d810ec50869479322e8396",1,1,1,191,764,21244,"0.0.0.0",0,5295685118145168,false,1675544628,775044,775044,"[{""sequence"":4294967295,""witness"":"""",""script"":""47304402205f97d7cfdbc22bcfeb8a65d09ecea1e42c61d7b46d1c9f64c13be250fbe6a88802207d0b329a29f8d404f2647ea6c17b3af10f2c62aa95d0e144dbe65130cbbb21058121037886d8592ed90701d2330f4e92cbcf0fc896be30c0353c2b5f9430a541b7c4bb"",""index"":0,""prev_out"":{""addr"":""1JuRHVjReBtEhsLQZ7SWCCi39drdoUXEHr"",""n"":10,""script"":""76a914c4640a393e33c8ebeb03b5771f8cbea423d4f59988ac"",""spending_outpoints"":[{""n"":0,""tx_index"":5295685118145168}],""spent"":true,""tx_index"":4800686028777367,""type"":0,""value"":104000}}]","[{""type"":0,""spent"":false,""value"":82756,""spending_outpoints"":[],""n"":0,""tx_index"":5295685118145168,""script"":""76a914a0b0d60e5991578ed37cbda2b17d8b2ce23ab29588ac"",""addr"":""1FeexV6bAHb8ybZjqQMjJrcCrHGW9sb6uF""}]",82756,7995725148881
"c7c87e4f8cb6fc4da569420f1f35fe449570df594459d38dbd4b43191e155c00",1,1,2,226,904,21244,"0.0.0.0",0,12655721130089,false,1675536420,775032,775032,"[{""sequence"":4294967295,""witness"":"""",""script"":""4830450221009cc4ed84b7e36517b0aa6cca89134daa658cb6c0c29fb6ed54e42694720a1d6102203d9cc35d5a4dbc78b2fa1f44f9b289dbc0ecba2b52bfb795428fdd4824bf43608121037886d8592ed90701d2330f4e92cbcf0fc896be30c0353c2b5f9430a541b7c4bb"",""index"":0,""prev_out"":{""addr"":""1JuRHVjReBtEhsLQZ7SWCCi39drdoUXEHr"",""n"":0,""script"":""76a914c4640a393e33c8ebeb03b5771f8cbea423d4f59988ac"",""spending_outpoints"":[{""n"":0,""tx_index"":12655721130089}],""spent"":true,""tx_index"":2338200499592430,""type"":0,""value"":42915}}]","[{""type"":0,""spent"":false,""value"":13972,""spending_outpoints"":[],""n"":0,""tx_index"":12655721130089,""script"":""76a914a0b0d60e5991578ed37cbda2b17d8b2ce23ab29588ac"",""addr"":""1FeexV6bAHb8ybZjqQMjJrcCrHGW9sb6uF""},{""type"":0,""spent"":false,""value"":7699,""spending_outpoints"":[],""n"":1,""tx_index"":12655721130089,""script"":""76a914c4640a393e33c8ebeb03b5771f8cbea423d4f59988ac"",""addr"":""1JuRHVjReBtEhsLQZ7SWCCi39drdoUXEHr""}]",13972,7995725066125
"6d0d497e9c67c58259d946870d06667ba8c36aee7c1388bbbe1cf6ecfba98773",1,2,1,343,721,4344,"0.0.0.0",0,4064848308444867,false,1675514817,774998,774998,"[{""sequence"":0,""witness"":""02483045022100f5f5a335eaa1573ae4faf19a484be387774d4614788cbdfbf74d3cb1a0176c320220246f758d1461130b6e1e338061da43f60ccf5bd52f73a434475ffe716b968b2601210362158b77e7a2ca91f0ab279f8c5d5844821a31c4cec1a32e364fe149922d2f6f"",""script"":"""",""index"":0,""prev_out"":{""addr"":""bc1qcs2a5chccd59fh29mk3htlpgz99r4vr6rh4u32"",""n"":32,""script"":""0014c415da62f8c36854dd45dda375fc28114a3ab07a"",""spending_outpoints"":[{""n"":0,""tx_index"":4064848308444867}],""spent"":true,""tx_index"":124267425920793,""type"":0,""value"":13666}},{""sequence"":0,""witness"":""02473044022018d40504d808caa0b5af57a1a2ff1eb17020a1b63d5c1be5c0b78739e5716f76022047b604233e75f811f0c310f529ed240c75223d02695dce6193dc6c5548f2e9a701210362158b77e7a2ca91f0ab279f8c5d5844821a31c4cec1a32e364fe149922d2f6f"",""script"":"""",""index"":1,""prev_out"":{""addr"":""bc1qcs2a5chccd59fh29mk3htlpgz99r4vr6rh4u32"",""n"":0,""script"":""0014c415da62f8c36854dd45dda375fc28114a3ab07a"",""spending_outpoints"":[{""n"":1,""tx_index"":4064848308444867}],""spent"":true,""tx_index"":5957871608689016,""type"":0,""value"":48793}}]","[{""type"":0,""spent"":false,""value"":58115,""spending_outpoints"":[],""n"":0,""tx_index"":4064848308444867,""script"":""76a914a0b0d60e5991578ed37cbda2b17d8b2ce23ab29588ac"",""addr"":""1FeexV6bAHb8ybZjqQMjJrcCrHGW9sb6uF""}]",58115,7995725052153
"daf6e138c0bd81daf48ecb608cf6b6db2c85f96b841fbab14b33135b810cbbef",1,1,2,225,573,5040,"0.0.0.0",0,8434772727259750,false,1675468806,774929,774929,"[{""sequence"":0,""witness"":""0247304402203621063551b98ff9245d4050153697e274232eebee8179a8fc5971af4de0c89c02201aad701ef96e6c5b57b06ae6da6666d36af3cdc086857c21ef66861384d3ae6b01210362158b77e7a2ca91f0ab279f8c5d5844821a31c4cec1a32e364fe149922d2f6f"",""script"":"""",""index"":0,""prev_out"":{""addr"":""bc1qcs2a5chccd59fh29mk3htlpgz99r4vr6rh4u32"",""n"":0,""script"":""0014c415da62f8c36854dd45dda375fc28114a3ab07a"",""spending_outpoints"":[{""n"":0,""tx_index"":8434772727259750}],""spent"":true,""tx_index"":3630441223437580,""type"":0,""value"":66173}}]","[{""type"":0,""spent"":false,""value"":8490,""spending_outpoints"":[],""n"":0,""tx_index"":8434772727259750,""script"":""76a914a0b0d60e5991578ed37cbda2b17d8b2ce23ab29588ac"",""addr"":""1FeexV6bAHb8ybZjqQMjJrcCrHGW9sb6uF""},{""type"":0,""spent"":true,""value"":52643,""spending_outpoints"":[{""tx_index"":5957871608689016,""n"":0}],""n"":1,""tx_index"":8434772727259750,""script"":""0014c415da62f8c36854dd45dda375fc28114a3ab07a"",""addr"":""bc1qcs2a5chccd59fh29mk3htlpgz99r4vr6rh4u32""}]",8490,7995724994038
"f59b617c5dea120487654bd7e7f4ca517eac18cc54fb54c6fd4431ad807f8466",1,1,1,340,700,7280,"0.0.0.0",0,3607016347379240,false,1672024212,768939,768939,"[{""sequence"":4294967295,""witness"":""0400473044022056070f20d887bfb2a9e52c83a39074069d7e24733999785ed42adfcd5fe97c51022030df1fc3977b7f50f20d4709cca4d9002b66c49beda8b6bafa2f089cc6238d310147304402207726bd9358b630e0b4d1f89abffde1a154fde333761a781b95ab15f8a5219ca30220272f8b753fdacd384bff04fff7e8ee2b335aeb8ff15332f01be6fcb5e23bb8160147522102a7ae26824d8388f5b8f392caeeffce5d02006643e8a5108d4d93d6ab288f45982102396ad02fecce49cec7bc3484a9fe81f0b9ce1326657b61414e791979f8984b0e52ae"",""script"":""220020d6729bbde41df697f045d9fad85cd65cd4958c74eaf16ba9ff920dadaa4e4b57"",""index"":0,""prev_out"":{""addr"":""3MvYswDnJKTuHQQaTevYFiVw7b5RSnLG1U"",""n"":0,""script"":""a914ddf1c35d10d67a9e7dc82d2edf604fa70924bfa187"",""spending_outpoints"":[{""n"":0,""tx_index"":3607016347379240}],""spent"":true,""tx_index"":8257891344876943,""type"":0,""value"":2782125}}]","[{""type"":0,""spent"":false,""value"":2774845,""spending_outpoints"":[],""n"":0,""tx_index"":3607016347379240,""script"":""76a914a0b0d60e5991578ed37cbda2b17d8b2ce23ab29588ac"",""addr"":""1FeexV6bAHb8ybZjqQMjJrcCrHGW9sb6uF""}]",2774845,7995724985548
"30dd36ac7da23e028bd1c95cdc790a9d00d4cc3d30b3b2f415654dd35b30070a",1,1,15,663,2322,10268,"0.0.0.0",0,352831755938220,false,1671302416,767827,767827,"[{""sequence"":4294967295,""witness"":""02483045022100fd17e71dcfdc0cde9a0a549d5d31c591431b3a0d999c0ab968cd3d0a84c9e3a60220155fbea853356e550914a828e4685acce794da6586a14d598b6e73dbd8cbf7270121030f7c3def8105edb2e0f7dbed23e19ba49e4485b731a24bcc14aee8d51a75ee38"",""script"":"""",""index"":0,""prev_out"":{""addr"":""bc1qmgj3w0aw5455y9s4zfhts2kxm4qstwyjx5f907"",""n"":4,""script"":""0014da25173faea569421615126eb82ac6dd4105b892"",""spending_outpoints"":[{""n"":0,""tx_index"":352831755938220}],""spent"":true,""tx_index"":2642064207949448,""type"":0,""value"":1032961605}}]","[{""type"":0,""spent"":true,""value"":380000,""spending_outpoints"":[{""tx_index"":397207611386847,""n"":1}],""n"":0,""tx_index"":352831755938220,""script"":""001461b2f3e4d5c0b6d42d9b49319c7e4ab3beabe21b"",""addr"":""bc1qvxe08ex4czmdgtvmfyceclj2kwl2hcsm5kux7s""},{""type"":0,""spent"":false,""value"":100000,""spending_outpoints"":[],""n"":1,""tx_index"":352831755938220,""script"":""76a914509b4ffd5232ddb5136a7afafdc04e5224bdadb188ac"",""addr"":""18MD7eRiQah3exzapW8kG6qPT7Wh1FmD5b""},{""type"":0,""spent"":false,""value"":58840,""spending_outpoints"":[],""n"":2,""tx_index"":352831755938220,""script"":""0014f781bc7fff2dcaf5857bc1ae4cadd5558892b49c"",""addr"":""bc1q77qmclll9h90tptmcxhyetw42kyf9dyusywecd""},{""type"":0,""spent"":false,""value"":14018410,""spending_outpoints"":[],""n"":3,""tx_index"":352831755938220,""script"":""a9146498e82781f691ea993db57144d9e7d232f8718787"",""addr"":""3Arvft4ZRN1DVaZFCjFjQyAeZA7E52Hy6A""},{""type"":0,""spent"":true,""value"":565334,""spending_outpoints"":[{""tx_index"":2746604676719571,""n"":0}],""n"":4,""tx_index"":352831755938220,""script"":""a9142203df7bc008ebb3085fc21756d6f8d0661ac38f87"",""addr"":""34nsYAYz6n37bMf5zMAVGtAa1sq9zyBSDH""},{""type"":0,""spent"":true,""value"":178511,""spending_outpoints"":[{""tx_index"":7365042656547222,""n"":0}],""n"":5,""tx_index"":352831755938220,""script"":""76a9141fa940005c2d834758871d42cd5d31e93c855c4688ac"",""addr"":""13tQheK1qK365XTuFyTQ2GxzF5pVkScQp7""},{""type"":0,""spent"":true,""value"":95127,""spending_outpoints"":[{""tx_index"":3130760408793202,""n"":38}],""n"":6,""tx_index"":352831755938220,""script"":""00146180a51e1aa68869b8f8622e66ac03cf9eb5b732"",""addr"":""bc1qvxq228s656yxnw8cvghxdtqre70ttdejjcpm45""},{""type"":0,""spent"":true,""value"":160808,""spending_outpoints"":[{""tx_index"":866168969358098,""n"":11}],""n"":7,""tx_index"":352831755938220,""script"":""0020b563c3a890b16c8cfea0e33a6423ca0b67b7fdbb44dcb95dc788056e33fb8765"",""addr"":""bc1qk43u82ysk9kgel4quvaxgg72pdnm0ldmgnwtjhw83qzkuvlmsajs3tuppy""},{""type"":0,""spent"":false,""value"":1178499,""spending_outpoints"":[],""n"":8,""tx_index"":352831755938220,""script"":""00143467f065d3783bf84aa0c8ed6ce98852462223ac"",""addr"":""bc1qx3nlqewn0qalsj4qerkke6vg2frzygavdcp9gk""},{""type"":0,""spent"":false,""value"":2381267,""spending_outpoints"":[],""n"":9,""tx_index"":352831755938220,""script"":""0014eb4465642b754dcf47ba0a9f38b9f4f10d72bdd6"",""addr"":""bc1qadzx2eptw4xu73a6p20n3w057yxh90wkux5rrj""},{""type"":0,""spent"":true,""value"":15529,""spending_outpoints"":[{""tx_index"":1895705461556583,""n"":0}],""n"":10,""tx_index"":352831755938220,""script"":""a9148ee742b97d25ec63117d5a0b5ad52ac0755504e787"",""addr"":""3Eicv48iJ6hoPeVuBMCNiSKL3G3jayY1UA""},{""type"":0,""spent"":false,""value"":5000,""spending_outpoints"":[],""n"":11,""tx_index"":352831755938220,""script"":""76a914a0b0d60e5991578ed37cbda2b17d8b2ce23ab29588ac"",""addr"":""1FeexV6bAHb8ybZjqQMjJrcCrHGW9sb6uF""},{""type"":0,""spent"":false,""value"":42111,""spending_outpoints"":[],""n"":12,""tx_index"":352831755938220,""script"":""0020f7c9d7934cc1b9f613b7e4ecaad5ee460cf65755aeab8fc5fc6cbfd162804cbf"",""addr"":""bc1q7lya0y6vcxulvyahunk2440wgcx0v464464cl30udjlazc5qfjls0e7sru""},{""type"":0,""spent"":true,""value"":6061137,""spending_outpoints"":[{""tx_index"":1126164321880141,""n"":10}],""n"":13,""tx_index"":352831755938220,""script"":""a914328300a65fa5404f8ce25e9f558cf212799ece6687"",""addr"":""36J6eMKoWyooKzkJu2AyRJzBKfWXMC34aL""},{""type"":0,""spent"":true,""value"":1007710764,""spending_outpoints"":[{""tx_index"":5464003745162119,""n"":0}],""n"":14,""tx_index"":352831755938220,""script"":""0014da25173faea569421615126eb82ac6dd4105b892"",""addr"":""bc1qmgj3w0aw5455y9s4zfhts2kxm4qstwyjx5f907""}]",5000,7995722210703
"031b90879d0cb0ff1fe0d39d4e207a642352a0e8d0a1fb0063ac7d004d7caa80",2,1,1,224,896,384,"0.0.0.0",0,4527030982938549,false,1671254653,767758,767758,"[{""sequence"":4294967295,""witness"":"""",""script"":""483045022100ede875b8502c52eb98be837dc7dc5182d1ec82219994a350985d354edd98e9d202207b29aa28c130401359576f00a8718e368d210beb28bf8f92158043710030978001410437162c3dd7cc995b5d8555e1a4040205bcfa9e0e081bf420d79230ab60f9f4c5de246e28135f13f1d786e574cb0d2f0ac26df7b0ba0d91fe0063560704c555cf"",""index"":0,""prev_out"":{""addr"":""12345678pvjrJYYoiAZ5MVzzBprctCYk2w"",""n"":0,""script"":""76a9140b5b85544f7cf56a07e354d4b2df27af08da5d8c88ac"",""spending_outpoints"":[{""n"":0,""tx_index"":4527030982938549}],""spent"":true,""tx_index"":7408766469654300,""type"":0,""value"":1000}}]","[{""type"":0,""spent"":false,""value"":616,""spending_outpoints"":[],""n"":0,""tx_index"":4527030982938549,""script"":""76a914a0b0d60e5991578ed37cbda2b17d8b2ce23ab29588ac"",""addr"":""1FeexV6bAHb8ybZjqQMjJrcCrHGW9sb6uF""}]",616,7995722205703
"cf858cf72c9e2fe31b25cbe5b61268daf34c446a584639635e4d6b3937daa9d1",2,1,2,378,834,1377,"0.0.0.0",766171,7376878103375209,false,1670349622,766198,766198,"[{""sequence"":4294967293,""witness"":""034730440220089e90df6c384f0eaa43bd860800426e5dfaab9a2ef038c327c7101634d432f00220365fe4f30255ecbbefd2dccbdb74a63a7431d645c51d7fc9fb80f4ecdbb80cff0147304402206d0060ede4eb8ad7fb00e8ad4f044394dbf47810fb81ecde915025c36f1468ea022023e2a5334257573a1469f331990a5424b28b0e49a181527d3071583f43d8b3b9014e210238f7eadfed67a8e261b06acc9033c3f89e1c3169b6d18bd81ce3d89a46d5acb0ad2102c3fd25f5c02cbc1bdaa58b6543a1c331a3e8388799f103997f67a9f4ad7e32c6ac73640380ca00b268"",""script"":""220020a6bb876b6de9a99e604abbbcc49246f4a257d62e3c7a495250267cf3c63dbe77"",""index"":0,""prev_out"":{""addr"":""3HFrVs6933sdxSqfJEHxkPdXXdS3aN1Sds"",""n"":0,""script"":""a914aabfbed7c0e70e806b521eb71253308c1d268eea87"",""spending_outpoints"":[{""n"":0,""tx_index"":7376878103375209}],""spent"":true,""tx_index"":7092801341142531,""type"":0,""value"":1398036}}]","[{""type"":0,""spent"":true,""value"":1390765,""spending_outpoints"":[{""tx_index"":5370923386402787,""n"":0}],""n"":0,""tx_index"":7376878103375209,""script"":""a914b4826c0e46d0a017ff460fc0415e268c14f306d687"",""addr"":""3J9TnxaggbbcqjXXbiA2FyU4YpFXh2rYFj""},{""type"":0,""spent"":false,""value"":5894,""spending_outpoints"":[],""n"":1,""tx_index"":7376878103375209,""script"":""76a914a0b0d60e5991578ed37cbda2b17d8b2ce23ab29588ac"",""addr"":""1FeexV6bAHb8ybZjqQMjJrcCrHGW9sb6uF""}]",5894,7995722205087
"065b0351bf65b47b15d964d86c66c0c5c370cf3a51cebec7cbaf7ef04b3aa0fb",2,1,1,191,764,192,"0.0.0.0",0,8853298924621781,false,1669196229,764394,764394,"[{""sequence"":4294967295,""witness"":"""",""script"":""473044022074943d353908a06398ce316c49ff65fdecc5afafe0b914e4b54e6382bcd60f04022051ef38278bd9e50ccb2f5454abe474f7514216e8f5d39c124b884b2d8a7c3c7d01210388f723869721497dec2b55fc01fe38d176eeddcfa7a8b44ca4272379171290b6"",""index"":0,""prev_out"":{""addr"":""1MTx734zsut1LPBeq7fhArfR8vFEeDKXbz"",""n"":0,""script"":""76a914e07b5448eb09ff9cf251b0a6e7611c72227418e388ac"",""spending_outpoints"":[{""n"":0,""tx_index"":8853298924621781}],""spent"":true,""tx_index"":3304339745590160,""type"":0,""value"":4905}}]","[{""type"":0,""spent"":false,""value"":4713,""spending_outpoints"":[],""n"":0,""tx_index"":8853298924621781,""script"":""76a914a0b0d60e5991578ed37cbda2b17d8b2ce23ab29588ac"",""addr"":""1FeexV6bAHb8ybZjqQMjJrcCrHGW9sb6uF""}]",4713,7995722199193
"6ad73f12c55389f54b85c702ebe947d024731f6628aacedc85d83ab4fd627bbf",2,1,2,225,900,573,"0.0.0.0",0,6737173205649243,false,1666820223,760435,760435,"[{""sequence"":4294967293,""witness"":"""",""script"":""47304402205322613f88dd09dc5e13052df03c8c3a412302ec3e46146d786572ce5c5deb28022062ba7f9210736cbe0132fc0adb035a6d588a0a98107fa20db51cb2ff46665652012102c38d60a3f8c5dfcc71ef89e7c02cdf988ace780e24aaee829cf4ebac6bb0ad7e"",""index"":0,""prev_out"":{""addr"":""197WadaVX1gDTERpwtHryjUX9ZuV4kry6U"",""n"":2,""script"":""76a91458fc31ad0db0c05ce6cc18cb1a86e5c21205e74c88ac"",""spending_outpoints"":[{""n"":0,""tx_index"":6737173205649243}],""spent"":true,""tx_index"":6545616721137978,""type"":0,""value"":35964}}]","[{""type"":0,""spent"":false,""value"":1100,""spending_outpoints"":[],""n"":0,""tx_index"":6737173205649243,""script"":""76a914a0b0d60e5991578ed37cbda2b17d8b2ce23ab29588ac"",""addr"":""1FeexV6bAHb8ybZjqQMjJrcCrHGW9sb6uF""},{""type"":0,""spent"":true,""value"":34291,""spending_outpoints"":[{""tx_index"":175145493043000,""n"":0}],""n"":1,""tx_index"":6737173205649243,""script"":""76a91458fc31ad0db0c05ce6cc18cb1a86e5c21205e74c88ac"",""addr"":""197WadaVX1gDTERpwtHryjUX9ZuV4kry6U""}]",1100,7995722194480
"b9bd0322af4f5ab71cce044bb5a24de79e4438fd22f6acaf3249b544d5d2b6f7",2,1,21,891,3564,891,"0.0.0.0",760011,8715666985621161,false,1666555548,760031,760031,"[{""sequence"":4294967293,""witness"":"""",""script"":""47304402206ec8b29df336f31bee9868c2fcc51c5b893bd27b3ef31991967915c298032350022063b442f941daf3d6303493193a5d5c715e3a40b2b4861d7e843edd7afebd4a930141040e1442fb42d364f542098626047f64be1bfd355b8ec2820c5412530db438ff87010d9e62a02ac5136c3b31bb29fc4a88d42d38d68c268098cf6dd8d94582cf9a"",""index"":0,""prev_out"":{""addr"":""1DonateMeSvZxGUYYXxf7zUjKdmJpFgZCV"",""n"":0,""script"":""76a9148c7ab20d92b02c9f3d74e6e4ab4245230c1697af88ac"",""spending_outpoints"":[{""n"":0,""tx_index"":8715666985621161}],""spent"":true,""tx_index"":971090026008905,""type"":0,""value"":49746}}]","[{""type"":0,""spent"":false,""value"":777,""spending_outpoints"":[],""n"":0,""tx_index"":8715666985621161,""script"":""a91423e522dfc6656a8fda3d47b4fa53f7585ac758cd87"",""addr"":""34xp4vRoCGJym3xR7yCVPFHoCNxv4Twseo""},{""type"":0,""spent"":true,""value"":777,""spending_outpoints"":[{""tx_index"":8606206320244199,""n"":22}],""n"":1,""tx_index"":8715666985621161,""script"":""00204364063fac8829a931a752ecd9049e43425e2cebf83681876c556002bf389b00"",""addr"":""bc1qgdjqv0av3q56jvd82tkdjpy7gdp9ut8tlqmgrpmv24sq90ecnvqqjwvw97""},{""type"":0,""spent"":true,""value"":777,""spending_outpoints"":[{""tx_index"":1738904222547825,""n"":5}],""n"":2,""tx_index"":8715666985621161,""script"":""a914d401a46b6d847399a45878b1f25f499aad95983087"",""addr"":""3M219KR5vEneNb47ewrPfWyb5jQ2DjxRP6""},{""type"":0,""spent"":false,""value"":777,""spending_outpoints"":[],""n"":3,""tx_index"":8715666985621161,""script"":""76a914d4eac89d456a48d2405645c4602264961215968b88ac"",""addr"":""1LQoWist8KkaUXSPKZHNvEyfrEkPHzSsCd""},{""type"":0,""spent"":true,""value"":777,""spending_outpoints"":[{""tx_index"":942308872144661,""n"":52}],""n"":4,""tx_index"":8715666985621161,""script"":""a914cec49f4d16b05fe163e41b15856732d985d3627787"",""addr"":""3LYJfcfHPXYJreMsASk2jkn69LWEYKzexb""},{""type"":0,""spent"":false,""value"":777,""spending_outpoints"":[],""n"":5,""tx_index"":8715666985621161,""script"":""0014e8b1bf6a27a1e76929b229f595f64cd381c87d87"",""addr"":""bc1qazcm763858nkj2dj986etajv6wquslv8uxwczt""},{""type"":0,""spent"":false,""value"":777,""spending_outpoints"":[],""n"":6,""tx_index"":8715666985621161,""script"":""a9144017a4219d12f11e4649d2ae9eef5bd4c9bf0d8087"",""addr"":""37XuVSEpWW4trkfmvWzegTHQt7BdktSKUs""},{""type"":0,""spent"":false,""value"":777,""spending_outpoints"":[],""n"":7,""tx_index"":8715666985621161,""script"":""76a914a0b0d60e5991578ed37cbda2b17d8b2ce23ab29588ac"",""addr"":""1FeexV6bAHb8ybZjqQMjJrcCrHGW9sb6uF""},{""type"":0,""spent"":false,""value"":777,""spending_outpoints"":[],""n"":8,""tx_index"":8715666985621161,""script"":""0014ed1d64772e536cca6ac964aa593faca4f7fad0c5"",""addr"":""bc1qa5wkgaew2dkv56kfvj49j0av5nml45x9ek9hz6""},{""type"":0,""spent"":true,""value"":777,""spending_outpoints"":[{""tx_index"":8491764192401227,""n"":4}],""n"":9,""tx_index"":8715666985621161,""script"":""a914c8ca150ee82589d47f69b8dcd7cad684d88283f187"",""addr"":""3Kzh9qAqVWQhEsfQz7zEQL1EuSx5tyNLNS""},{""type"":0,""spent"":true,""value"":777,""spending_outpoints"":[{""tx_index"":2925192081882515,""n"":3}],""n"":10,""tx_index"":8715666985621161,""script"":""00206d490c8afb205cb251b377b0798094bd26643cc0833b94b5e09d2c08a98e9b80"",""addr"":""bc1qd4ysezhmypwty5dnw7c8nqy5h5nxg0xqsvaefd0qn5kq32vwnwqqgv4rzr""},{""type"":0,""spent"":true,""value"":33315,""spending_outpoints"":[{""tx_index"":5871895716172350,""n"":0}],""n"":11,""tx_index"":8715666985621161,""script"":""76a9148c7ab20d92b02c9f3d74e6e4ab4245230c1697af88ac"",""addr"":""1DonateMeSvZxGUYYXxf7zUjKdmJpFgZCV""},{""type"":0,""spent"":false,""value"":777,""spending_outpoints"":[],""n"":12,""tx_index"":8715666985621161,""script"":""76a914d74de95f65799793f16b91ed8a152110652d3ec088ac"",""addr"":""1LdRcdxfbSnmCYYNdeYpUnztiYzVfBEQeC""},{""type"":0,""spent"":false,""value"":777,""spending_outpoints"":[],""n"":13,""tx_index"":8715666985621161,""script"":""76a91464d0c396792fda739dbb4caa162fb23e7b1b6ee288ac"",""addr"":""1AC4fMwgY8j9onSbXEWeH6Zan8QGMSdmtA""},{""type"":0,""spent"":true,""value"":777,""spending_outpoints"":[{""tx_index"":2811030882517301,""n"":2}],""n"":14,""tx_index"":8715666985621161,""script"":""a914288b23e4a5886136a544159550a8e99f2e5672ab87"",""addr"":""35PPdr9CSZuqwi2S7vj9ResHQCVTsYuB3z""},{""type"":0,""spent"":true,""value"":777,""spending_outpoints"":[{""tx_index"":792189084429949,""n"":5}],""n"":15,""tx_index"":8715666985621161,""script"":""0014d9a594cf847e991ad19a65dc172df4689625ecd5"",""addr"":""bc1qmxjefnuy06v345v6vhwpwt05dztztmx4g3y7wp""},{""type"":0,""spent"":false,""value"":777,""spending_outpoints"":[],""n"":16,""tx_index"":8715666985621161,""script"":""76a914d9da7d6362c9f89c4b389a551b4038fedffd461288ac"",""addr"":""1LruNZjwamWJXThX2Y8C2d47QqhAkkc5os""},{""type"":0,""spent"":true,""value"":777,""spending_outpoints"":[{""tx_index"":6911363901646531,""n"":1}],""n"":17,""tx_index"":8715666985621161,""script"":""a914cafacdc40cf8d3daa60aa479774ccd9085b4c51287"",""addr"":""3LCGsSmfr24demGvriN4e3ft8wEcDuHFqh""},{""type"":0,""spent"":false,""value"":777,""spending_outpoints"":[],""n"":18,""tx_index"":8715666985621161,""script"":""a914cd49d5f5215aaaa0fdbf1bd2e454250edf8a54e287"",""addr"":""3LQUu4v9z6KNch71j7kbj8GPeAGUo1FW6a""},{""type"":0,""spent"":false,""value"":777,""spending_outpoints"":[],""n"":19,""tx_index"":8715666985621161,""script"":""0014f11a35b66716946bc3e0201645c4fbdd72ac56f1"",""addr"":""bc1q7ydrtdn8z62xhslqyqtyt38mm4e2c4h3mxjkug""},{""type"":0,""spent"":true,""value"":777,""spending_outpoints"":[{""tx_index"":2389772459907851,""n"":3}],""n"":20,""tx_index"":8715666985621161,""script"":""a9144a782fe173a0b6718d39667b420d9c8b07e9426287"",""addr"":""38UmuUqPCrFmQo4khkomQwZ4VbY2nZMJ67""}]",777,7995722193380
"59d8682c50a7e7e38df3472e39a08dc0d38598bb9c13366720bb6a2f5f7d6189",2,1,21,891,3564,891,"0.0.0.0",760011,4833657863138647,false,1666555781,760031,760031,"[{""sequence"":4294967293,""witness"":"""",""script"":""473044022052eeb95270efd62660ac83285904167c3160eecfb16ee055889ac67ce71bd78302202506e94361b5227e60d8bc64eddeaa7d1ca05e022b38997e063884215aceb6c6014104868cbc4e5583149b62dfb4708019e25e43b55a401088fcc23196292f4694c834178634357eafe131146add03c6c2cf4b8bae256be70755da409cbe782e0949ff"",""index"":0,""prev_out"":{""addr"":""1FULLnode6c21o3DEYyLR9xdSiWksnTRjc"",""n"":1,""script"":""76a9149ebd231d289946c9311d68b8c092ac3bfbedc31688ac"",""spending_outpoints"":[{""n"":0,""tx_index"":4833657863138647}],""spent"":true,""tx_index"":256694867067008,""type"":0,""value"":49746}}]","[{""type"":0,""spent"":false,""value"":777,""spending_outpoints"":[],""n"":0,""tx_index"":4833657863138647,""script"":""a91423e522dfc6656a8fda3d47b4fa53f7585ac758cd87"",""addr"":""34xp4vRoCGJym3xR7yCVPFHoCNxv4Twseo""},{""type"":0,""spent"":true,""value"":777,""spending_outpoints"":[{""tx_index"":8606206320244199,""n"":10}],""n"":1,""tx_index"":4833657863138647,""script"":""00204364063fac8829a931a752ecd9049e43425e2cebf83681876c556002bf389b00"",""addr"":""bc1qgdjqv0av3q56jvd82tkdjpy7gdp9ut8tlqmgrpmv24sq90ecnvqqjwvw97""},{""type"":0,""spent"":true,""value"":777,""spending_outpoints"":[{""tx_index"":1738904222547825,""n"":4}],""n"":2,""tx_index"":4833657863138647,""script"":""a914d401a46b6d847399a45878b1f25f499aad95983087"",""addr"":""3M219KR5vEneNb47ewrPfWyb5jQ2DjxRP6""},{""type"":0,""spent"":false,""value"":777,""spending_outpoints"":[],""n"":3,""tx_index"":4833657863138647,""script"":""76a914d4eac89d456a48d2405645c4602264961215968b88ac"",""addr"":""1LQoWist8KkaUXSPKZHNvEyfrEkPHzSsCd""},{""type"":0,""spent"":true,""value"":777,""spending_outpoints"":[{""tx_index"":942308872144661,""n"":51}],""n"":4,""tx_index"":4833657863138647,""script"":""a914cec49f4d16b05fe163e41b15856732d985d3627787"",""addr"":""3LYJfcfHPXYJreMsASk2jkn69LWEYKzexb""},{""type"":0,""spent"":false,""value"":777,""spending_outpoints"":[],""n"":5,""tx_index"":4833657863138647,""script"":""0014e8b1bf6a27a1e76929b229f595f64cd381c87d87"",""addr"":""bc1qazcm763858nkj2dj986etajv6wquslv8uxwczt""},{""type"":0,""spent"":false,""value"":777,""spending_outpoints"":[],""n"":6,""tx_index"":4833657863138647,""script"":""a9144017a4219d12f11e4649d2ae9eef5bd4c9bf0d8087"",""addr"":""37XuVSEpWW4trkfmvWzegTHQt7BdktSKUs""},{""type"":0,""spent"":false,""value"":777,""spending_outpoints"":[],""n"":7,""tx_index"":4833657863138647,""script"":""76a914a0b0d60e5991578ed37cbda2b17d8b2ce23ab29588ac"",""addr"":""1FeexV6bAHb8ybZjqQMjJrcCrHGW9sb6uF""},{""type"":0,""spent"":false,""value"":777,""spending_outpoints"":[],""n"":8,""tx_index"":4833657863138647,""script"":""0014ed1d64772e536cca6ac964aa593faca4f7fad0c5"",""addr"":""bc1qa5wkgaew2dkv56kfvj49j0av5nml45x9ek9hz6""},{""type"":0,""spent"":true,""value"":777,""spending_outpoints"":[{""tx_index"":8491764192401227,""n"":0}],""n"":9,""tx_index"":4833657863138647,""script"":""a914c8ca150ee82589d47f69b8dcd7cad684d88283f187"",""addr"":""3Kzh9qAqVWQhEsfQz7zEQL1EuSx5tyNLNS""},{""type"":0,""spent"":true,""value"":777,""spending_outpoints"":[{""tx_index"":2925192081882515,""n"":1}],""n"":10,""tx_index"":4833657863138647,""script"":""00206d490c8afb205cb251b377b0798094bd26643cc0833b94b5e09d2c08a98e9b80"",""addr"":""bc1qd4ysezhmypwty5dnw7c8nqy5h5nxg0xqsvaefd0qn5kq32vwnwqqgv4rzr""},{""type"":0,""spent"":false,""value"":777,""spending_outpoints"":[],""n"":11,""tx_index"":4833657863138647,""script"":""76a914d74de95f65799793f16b91ed8a152110652d3ec088ac"",""addr"":""1LdRcdxfbSnmCYYNdeYpUnztiYzVfBEQeC""},{""type"":0,""spent"":false,""value"":777,""spending_outpoints"":[],""n"":12,""tx_index"":4833657863138647,""script"":""76a91464d0c396792fda739dbb4caa162fb23e7b1b6ee288ac"",""addr"":""1AC4fMwgY8j9onSbXEWeH6Zan8QGMSdmtA""},{""type"":0,""spent"":true,""value"":777,""spending_outpoints"":[{""tx_index"":2811030882517301,""n"":1}],""n"":13,""tx_index"":4833657863138647,""script"":""a914288b23e4a5886136a544159550a8e99f2e5672ab87"",""addr"":""35PPdr9CSZuqwi2S7vj9ResHQCVTsYuB3z""},{""type"":0,""spent"":true,""value"":777,""spending_outpoints"":[{""tx_index"":792189084429949,""n"":4}],""n"":14,""tx_index"":4833657863138647,""script"":""0014d9a594cf847e991ad19a65dc172df4689625ecd5"",""addr"":""bc1qmxjefnuy06v345v6vhwpwt05dztztmx4g3y7wp""},{""type"":0,""spent"":true,""value"":33315,""spending_outpoints"":[{""tx_index"":6588286681121494,""n"":0}],""n"":15,""tx_index"":4833657863138647,""script"":""76a9149ebd231d289946c9311d68b8c092ac3bfbedc31688ac"",""addr"":""1FULLnode6c21o3DEYyLR9xdSiWksnTRjc""},{""type"":0,""spent"":false,""value"":777,""spending_outpoints"":[],""n"":16,""tx_index"":4833657863138647,""script"":""76a914d9da7d6362c9f89c4b389a551b4038fedffd461288ac"",""addr"":""1LruNZjwamWJXThX2Y8C2d47QqhAkkc5os""},{""type"":0,""spent"":true,""value"":777,""spending_outpoints"":[{""tx_index"":6911363901646531,""n"":0}],""n"":17,""tx_index"":4833657863138647,""script"":""a914cafacdc40cf8d3daa60aa479774ccd9085b4c51287"",""addr"":""3LCGsSmfr24demGvriN4e3ft8wEcDuHFqh""},{""type"":0,""spent"":false,""value"":777,""spending_outpoints"":[],""n"":18,""tx_index"":4833657863138647,""script"":""a914cd49d5f5215aaaa0fdbf1bd2e454250edf8a54e287"",""addr"":""3LQUu4v9z6KNch71j7kbj8GPeAGUo1FW6a""},{""type"":0,""spent"":false,""value"":777,""spending_outpoints"":[],""n"":19,""tx_index"":4833657863138647,""script"":""0014f11a35b66716946bc3e0201645c4fbdd72ac56f1"",""addr"":""bc1q7ydrtdn8z62xhslqyqtyt38mm4e2c4h3mxjkug""},{""type"":0,""spent"":true,""value"":777,""spending_outpoints"":[{""tx_index"":2389772459907851,""n"":0}],""n"":20,""tx_index"":4833657863138647,""script"":""a9144a782fe173a0b6718d39667b420d9c8b07e9426287"",""addr"":""38UmuUqPCrFmQo4khkomQwZ4VbY2nZMJ67""}]",777,7995722192603
"ef9b8a9d5332d44baaab88871235b34f4e7c2140d7da6e74a2f92370f51caf51",2,1,2,226,574,429,"0.0.0.0",0,2874001503159423,false,1666467775,759870,759870,"[{""sequence"":4294967295,""witness"":""02483045022100de13b0758d5b790ed18e8b68743b00832cd84d189476fdbf35de3c9452c94c9a022005109fc064db949a1e4fd8e7732053b30c2e856a1370b918806f793a012bb2d501210374565deee8f6ae3f3d5772ced85db6858358b1806dbc2ed9b9962b0b3bdbb9ae"",""script"":"""",""index"":0,""prev_out"":{""addr"":""bc1qlyw8vpcmxasfppaml245nfm570l24rtdtj4v0h"",""n"":1,""script"":""0014f91c76071b37609087bbfaab49a774f3feaa8d6d"",""spending_outpoints"":[{""n"":0,""tx_index"":2874001503159423}],""spent"":true,""tx_index"":3999846156497485,""type"":0,""value"":46127}}]","[{""type"":0,""spent"":false,""value"":546,""spending_outpoints"":[],""n"":0,""tx_index"":2874001503159423,""script"":""76a914a0b0d60e5991578ed37cbda2b17d8b2ce23ab29588ac"",""addr"":""1FeexV6bAHb8ybZjqQMjJrcCrHGW9sb6uF""},{""type"":0,""spent"":true,""value"":45152,""spending_outpoints"":[{""tx_index"":1113300207046184,""n"":0}],""n"":1,""tx_index"":2874001503159423,""script"":""00140a339b18600e596b7551c94a48ab4bb7901c7e10"",""addr"":""bc1qpgeekxrqpevkka23e99y326tk7gpclss8thxhl""}]",546,7995722191826
"3c5f611dd7e9c33885adc4de2d146e1a150c01d4bb7f393cad2897c29dc766e3",1,1,1,194,449,565,"0.0.0.0",0,8000978405577445,false,1665582875,758351,758351,"[{""sequence"":4294967294,""witness"":""024730440220175e12bfef4ee9d796746c584074001deb89761d3e73fa9a9f0b4fb331da80d102205694af1cabf022b9c97661efcccce63bf6c30fe4cd8d939bc308fbef90b0779e0121026f0dfe239a4544361864113e885d301c15daa8230c41280edd254008039c947f"",""script"":"""",""index"":0,""prev_out"":{""addr"":""bc1qdves5dce7e8nfdsg6c2zqk53e6lk0xk7fz5t6y"",""n"":1,""script"":""00146b330a3719f64f34b608d614205a91cebf679ade"",""spending_outpoints"":[{""n"":0,""tx_index"":8000978405577445}],""spent"":true,""tx_index"":4112458080700197,""type"":0,""value"":110000}}]","[{""type"":0,""spent"":false,""value"":109435,""spending_outpoints"":[],""n"":0,""tx_index"":8000978405577445,""script"":""76a914a0b0d60e5991578ed37cbda2b17d8b2ce23ab29588ac"",""addr"":""1FeexV6bAHb8ybZjqQMjJrcCrHGW9sb6uF""}]",109435,7995722191280
"2e568d88f1c64801e3de1223d71a869d520c6ea459d26ada1f2ef1f966a6d066",1,1,2,225,573,1008,"0.0.0.0",0,3617482591911461,false,1663593524,754808,754808,"[{""sequence"":4294967292,""witness"":""0247304402204c5473b72b978fb7176e5e97ae4785a39aa89d245646187f1c51b38269f9dd000220718baa3f890ad686e3f2abeddc4d414ea395bda35d105fff3820f7fb869a7edb0121035c19aeafee09cbd04c655014ca3c237c83b0b6c6dbf35c693e022d7d4c56ebba"",""script"":"""",""index"":0,""prev_out"":{""addr"":""bc1qps09z4cslapne82c98r6vxdnavs0xn9ned7hya"",""n"":2,""script"":""00140c1e515710ff433c9d5829c7a619b3eb20f34cb3"",""spending_outpoints"":[{""n"":0,""tx_index"":3617482591911461}],""spent"":true,""tx_index"":3546915953508663,""type"":0,""value"":34155}}]","[{""type"":0,""spent"":false,""value"":777,""spending_outpoints"":[],""n"":0,""tx_index"":3617482591911461,""script"":""76a914a0b0d60e5991578ed37cbda2b17d8b2ce23ab29588ac"",""addr"":""1FeexV6bAHb8ybZjqQMjJrcCrHGW9sb6uF""},{""type"":0,""spent"":true,""value"":32370,""spending_outpoints"":[{""tx_index"":8180581913433980,""n"":1}],""n"":1,""tx_index"":3617482591911461,""script"":""00140c1e515710ff433c9d5829c7a619b3eb20f34cb3"",""addr"":""bc1qps09z4cslapne82c98r6vxdnavs0xn9ned7hya""}]",777,7995722081845
"6486bf7c0e2af07d734eb56ff97da526a11925e0a2c89c380349fca7dfbcad2b",1,1,36,1347,5061,16258,"0.0.0.0",0,1536806339542921,false,1662447665,752852,752852,"[{""sequence"":4294967293,""witness"":""0247304402202b32ef88784e96b815e2a02f585eedc4e70a5d5cb282b79cca0d70ab7b3fdedf022012a31a30201cc93e953ef9b57d44b6c7906030f11c2c4b25bb52928d2402b5b501210246f7ec596547e4f87f29aa1650f59fd9772bb964a75c82cdec80074c767b7926"",""script"":""1600142277d7263999a2f530efd926d6d595ef7b027c3d"",""index"":0,""prev_out"":{""addr"":""3NSa5aSknNkZzw4M8iiXRcW1sjid8quXdt"",""n"":26,""script"":""a914e39f3e8aac37cf712bd65ae854c3888a9242468887"",""spending_outpoints"":[{""n"":0,""tx_index"":1536806339542921}],""spent"":true,""tx_index"":8902396570802963,""type"":0,""value"":118732053}}]","[{""type"":0,""spent"":true,""value"":9005084,""spending_outpoints"":[{""tx_index"":4096686912383336,""n"":1}],""n"":0,""tx_index"":1536806339542921,""script"":""76a914c60cd337549d6184e4d8ebbbcdfddd4df24b98c488ac"",""addr"":""1K4CA5qe56uZgmfREMzKJVvBKTEXovZcsE""},{""type"":0,""spent"":true,""value"":1138362,""spending_outpoints"":[{""tx_index"":2162235730920402,""n"":261}],""n"":1,""tx_index"":1536806339542921,""script"":""a914a1baa5edfbf805bcaffcf65323aa72d70bc8b10e87"",""addr"":""3GSAJyDp9So3d3NWt5eHBJ4Et3piBgW11E""},{""type"":0,""spent"":true,""value"":1167000,""spending_outpoints"":[{""tx_index"":628258167809278,""n"":2}],""n"":2,""tx_index"":1536806339542921,""script"":""76a914d3363bc116c11f0e16e2d77e7b41348ba5ed4de388ac"",""addr"":""1LFnYgSNrhDFFfNtj2LBpir6JkrVCposmm""},{""type"":0,""spent"":true,""value"":1328627,""spending_outpoints"":[{""tx_index"":1515187254971400,""n"":42}],""n"":3,""tx_index"":1536806339542921,""script"":""76a914391acf7749d3ff0212f86ad1fba3c61abe8d1d1b88ac"",""addr"":""16CwdkmKDcnZPV7g7oyc66igC4puDvwM1j""},{""type"":0,""spent"":true,""value"":347622,""spending_outpoints"":[{""tx_index"":8914849421654921,""n"":127}],""n"":4,""tx_index"":1536806339542921,""script"":""0014a4616d337b563545b9fa6eb13325a10a408174e2"",""addr"":""bc1q53sk6vmm2c65tw06d6cnxfdppfqgza8ztden8e""},{""type"":0,""spent"":true,""value"":45324000,""spending_outpoints"":[{""tx_index"":3403136795867447,""n"":14}],""n"":5,""tx_index"":1536806339542921,""script"":""a91448c6777d2195d21e5cee2e4823d3d6a9ea4a7adf87"",""addr"":""38KpL4reZhBWfnbammsixF17jfokciFGwt""},{""type"":0,""spent"":true,""value"":176365,""spending_outpoints"":[{""tx_index"":8136914238231321,""n"":100}],""n"":6,""tx_index"":1536806339542921,""script"":""76a9144e5ad22ee2a1806aefedf267ea912cc15811b13288ac"",""addr"":""189JWKUAaMJac312dLGr7qR9UCyymhmeAf""},{""type"":0,""spent"":true,""value"":490263,""spending_outpoints"":[{""tx_index"":3329124653316761,""n"":258}],""n"":7,""tx_index"":1536806339542921,""script"":""a914632d951143ba81a447502ceb3323cdb7ed8433e987"",""addr"":""3AjRReZDL7pRvZGVhFeahRLrRmDoExfKYm""},{""type"":0,""spent"":true,""value"":2141611,""spending_outpoints"":[{""tx_index"":2162235730920402,""n"":192}],""n"":8,""tx_index"":1536806339542921,""script"":""a91409c9b80b695b2297c590698bff5dd4e4185e614987"",""addr"":""32amewsFCgt5jpQsyPErnsT3YeD5JdwQw4""},{""type"":0,""spent"":true,""value"":712679,""spending_outpoints"":[{""tx_index"":7592888932465579,""n"":1}],""n"":9,""tx_index"":1536806339542921,""script"":""a91405aa3f295c19e05e06ce6ddc81198e62124a382687"",""addr"":""32CyFTDDXNMsXfEyKLo5na3PUaRNmX8agf""},{""type"":0,""spent"":true,""value"":2090585,""spending_outpoints"":[{""tx_index"":7424826845715532,""n"":0}],""n"":10,""tx_index"":1536806339542921,""script"":""0014ec38a38738077e6f30348be249b452588cf150b0"",""addr"":""bc1qasu28pecqalx7vp5303yndzjtzx0z59sla3g7y""},{""type"":0,""spent"":true,""value"":377250,""spending_outpoints"":[{""tx_index"":2460334759650807,""n"":58}],""n"":11,""tx_index"":1536806339542921,""script"":""a9142b00f64aba173117253243267dc59ca23372782987"",""addr"":""35cQ8e1AHL82YFcRHt6YVo26vYyX5qS6kE""},{""type"":0,""spent"":true,""value"":10078000,""spending_outpoints"":[{""tx_index"":3558388336192302,""n"":22}],""n"":12,""tx_index"":1536806339542921,""script"":""76a914dfb35ac09aa8b7800199ab952a3d855ec01de2f988ac"",""addr"":""1MPpYYkVQZz9VwpDkoT2jq8346XW1v6DWC""},{""type"":0,""spent"":true,""value"":4035805,""spending_outpoints"":[{""tx_index"":2162235730920402,""n"":223}],""n"":13,""tx_index"":1536806339542921,""script"":""a914070c1bffc248286e931787be2ed961d33af577d587"",""addr"":""32LHAG4MvsWGF9Z9wrDWDJ5cN6LbDbHcij""},{""type"":0,""spent"":true,""value"":105756,""spending_outpoints"":[{""tx_index"":2047777418777874,""n"":187}],""n"":14,""tx_index"":1536806339542921,""script"":""a914457149030979e27bc8db359d0ac2a9bc60854ab287"",""addr"":""382CFySX9z7zwmEcJ6i8DSxS3Dw829GzH1""},{""type"":0,""spent"":true,""value"":92951,""spending_outpoints"":[{""tx_index"":5319487380892583,""n"":0}],""n"":15,""tx_index"":1536806339542921,""script"":""00141b2d0b141b57c3f468b828301aa05d60f6ff5a42"",""addr"":""bc1qrvksk9qm2lplg69c9qcp4gzavrm07kjza6hj8z""},{""type"":0,""spent"":true,""value"":132930,""spending_outpoints"":[{""tx_index"":2162235730920402,""n"":284}],""n"":16,""tx_index"":1536806339542921,""script"":""a914d04ca12d2ff6052f9c85fcbf5628f21787e01e0787"",""addr"":""3LgQGmA5UBPD3DZ3NG71X61xn8mqEymZH1""},{""type"":0,""spent"":true,""value"":115009,""spending_outpoints"":[{""tx_index"":9004518502162256,""n"":204}],""n"":17,""tx_index"":1536806339542921,""script"":""76a9149998fc0365970a8c1d44595fe27a6c2e1531414488ac"",""addr"":""1F19etsh4B7Zd8QojZV7HpEvtTV7rqHo2Y""},{""type"":0,""spent"":true,""value"":50214,""spending_outpoints"":[{""tx_index"":4965423772843967,""n"":519}],""n"":18,""tx_index"":1536806339542921,""script"":""a9147f7640afe9e9c049fee52293de7cf8527da2924787"",""addr"":""3DJyQFGMQdJ5ubKBycwnv5WgDN6NhxUn6i""},{""type"":0,""spent"":true,""value"":630125,""spending_outpoints"":[{""tx_index"":3359334423811081,""n"":0}],""n"":19,""tx_index"":1536806339542921,""script"":""a9143b79f6af0f62ff813159ce8a55b0fa39f0e284c487"",""addr"":""377Vu3P1srswbd2mkLfJ4cWMeGnLDLhURf""},{""type"":0,""spent"":true,""value"":142658,""spending_outpoints"":[{""tx_index"":7710436903950901,""n"":661}],""n"":20,""tx_index"":1536806339542921,""script"":""a914885dce4a3acef7abb6ac32ea1ab418f493b25f0a87"",""addr"":""3E84CNitoNKvmLq2xZFKU7kSVKgSoNGayh""},{""type"":0,""spent"":true,""value"":1904742,""spending_outpoints"":[{""tx_index"":15203071480347,""n"":2}],""n"":21,""tx_index"":1536806339542921,""script"":""a9147fd7b206e5dd51c08a7e16eae654d1024a611ae387"",""addr"":""3DLz8gmuNQTUKBnexYUAqjLZup35Mf2XDp""},{""type"":0,""spent"":true,""value"":2520070,""spending_outpoints"":[{""tx_index"":3705242076592987,""n"":81}],""n"":22,""tx_index"":1536806339542921,""script"":""a914c63267818feb80d9d9b9392a3b47f10dedc3f66187"",""addr"":""3Kkz6gP2H6XP5Tq2Hcyjopp1xEHPpTuaNX""},{""type"":0,""spent"":true,""value"":161241,""spending_outpoints"":[{""tx_index"":5232734772977548,""n"":539}],""n"":23,""tx_index"":1536806339542921,""script"":""a91418a28fe2891eb1557c7a076f7f3cc0d37e5814bd87"",""addr"":""33wGtA4Gf8kRLAzPnDb8RhHLw8aGg1ZWhD""},{""type"":0,""spent"":true,""value"":1253154,""spending_outpoints"":[{""tx_index"":8914849421654921,""n"":128}],""n"":24,""tx_index"":1536806339542921,""script"":""001427f346b8e2b70ff72259c446861b06b15c0cc4e4"",""addr"":""bc1qyle5dw8zku8lwgjec3rgvxcxk9wqe38yu360ww""},{""type"":0,""spent"":false,""value"":19564,""spending_outpoints"":[],""n"":25,""tx_index"":1536806339542921,""script"":""76a914a0b0d60e5991578ed37cbda2b17d8b2ce23ab29588ac"",""addr"":""1FeexV6bAHb8ybZjqQMjJrcCrHGW9sb6uF""},{""type"":0,""spent"":true,""value"":231840,""spending_outpoints"":[{""tx_index"":2093696911263232,""n"":34}],""n"":26,""tx_index"":1536806339542921,""script"":""76a9143ef4d1b0992a94e4191d47eb2fa092db026b281588ac"",""addr"":""16jtBDvbhwhJXTwTd7jdyuNFNq8Hhzr3Jw""},{""type"":0,""spent"":true,""value"":478705,""spending_outpoints"":[{""tx_index"":7112449808509816,""n"":581}],""n"":27,""tx_index"":1536806339542921,""script"":""a914ab6e2ef88113494a45689538ae7ebe71e6eb8c0a87"",""addr"":""3HKTU2eCT1zCG4YKZWbJzeunVyGzFKn3A2""},{""type"":0,""spent"":true,""value"":534330,""spending_outpoints"":[{""tx_index"":7525373080096972,""n"":5}],""n"":28,""tx_index"":1536806339542921,""script"":""76a9149d65b7038f1dad374312756d3ec9faf810c7924988ac"",""addr"":""1FMEwPm16jkknAWZf7P6DVD23v8snks8Nq""},{""type"":0,""spent"":false,""value"":37624,""spending_outpoints"":[],""n"":29,""tx_index"":1536806339542921,""script"":""0014bd2252a32a12abf13f97e85aeba2dc606f9099c2"",""addr"":""bc1qh5399ge2z24lz0uhapdwhgkuvphepxwz0v5qnv""},{""type"":0,""spent"":true,""value"":222420,""spending_outpoints"":[{""tx_index"":2445918742444331,""n"":15}],""n"":30,""tx_index"":1536806339542921,""script"":""a9148c121264e5136e526dc3e4a0b1e4d66aef7f5c3187"",""addr"":""3ETeB46wCJa1tPwU1HM9VKWt1sUxDfjbEX""},{""type"":0,""spent"":true,""value"":179575,""spending_outpoints"":[{""tx_index"":8914849421654921,""n"":121}],""n"":31,""tx_index"":1536806339542921,""script"":""a91405a4906e7b97fed7bba1d32eddf7381d5ba5c95287"",""addr"":""32CrSd5zifmHHisLQcxyUmcnNvz1aoVF1r""},{""type"":0,""spent"":true,""value"":260999,""spending_outpoints"":[{""tx_index"":8754524069334040,""n"":454}],""n"":32,""tx_index"":1536806339542921,""script"":""00143ed440e9d3968aac139ad55fb2c0f3fe4e0e54ce"",""addr"":""bc1q8m2yp6wnj692cyu6640m9s8nle8qu4xwjcjlpe""},{""type"":0,""spent"":true,""value"":12600349,""spending_outpoints"":[{""tx_index"":6825342535646940,""n"":71}],""n"":33,""tx_index"":1536806339542921,""script"":""a914824586df2961042e4fdfc398cbb0d70a4e2e8e2987"",""addr"":""3DZq4HrccwSuMLXh8rWjvXcKAKAcheaRja""},{""type"":0,""spent"":true,""value"":81699,""spending_outpoints"":[{""tx_index"":1627691528762004,""n"":0}],""n"":34,""tx_index"":1536806339542921,""script"":""a91421aecfee71fd386c19ec691e55d8ecd31c62691c87"",""addr"":""34m7e3L7wxaHUJ1z7G5mCGvEeGPTqibizA""},{""type"":0,""spent"":true,""value"":18546587,""spending_outpoints"":[{""tx_index"":751966880235456,""n"":28}],""n"":35,""tx_index"":1536806339542921,""script"":""a914c9003dd968df7175c44163ea9b933e785a39dc8e87"",""addr"":""3L1p2tUHPwrRN3qgf4Hm1R73e29hFshbnp""}]",19564,7995722081068
"6de4c85b6596192d28e80c6f89d5a83eea4646dea86d96e0c6ac52a74dcc6b49",2,1,1,191,764,384,"0.0.0.0",749038,2583274815023701,false,1660282170,749082,749082,"[{""sequence"":4294967294,""witness"":"""",""script"":""47304402205f3ff00cf4bc3a2bb5ecc8c7a14b1c18a57a6628edcb59d873726992804728a502205d48963d12fb34bda5944417dda2f551d8526de162c7ff9a953f366ee69d59a70121031dca01b2bce193ce66b046479867595eae14a01fb7f583469c352ce3f42f5971"",""index"":0,""prev_out"":{""addr"":""1BSYg4hk2nVDz9viusjgneof6AGtnBV5Rf"",""n"":0,""script"":""76a914728618bad514f8f4b3d244879b6d6863807de47688ac"",""spending_outpoints"":[{""n"":0,""tx_index"":2583274815023701}],""spent"":true,""tx_index"":4664509860786638,""type"":0,""value"":20518}}]","[{""type"":0,""spent"":false,""value"":20134,""spending_outpoints"":[],""n"":0,""tx_index"":2583274815023701,""script"":""76a914a0b0d60e5991578ed37cbda2b17d8b2ce23ab29588ac"",""addr"":""1FeexV6bAHb8ybZjqQMjJrcCrHGW9sb6uF""}]",20134,7995722061504
"2ed89eefbea4fa4d889af1639211784721f8bc462eb45eb799afd0a1d3020f7e",2,1,2,225,573,3186,"0.0.0.0",748610,4435293985061397,false,1660003688,748612,748612,"[{""sequence"":4294967294,""witness"":""02473044022049aafb04c13399ec01d79e5240984096895de0ca5da26ce0142875bcdf6d7dcc02207c7260d79ec4086264a1b6862bb85e4f96b508a1b6447a4d4b519247144497b301210376c7b478aed0eb29a0b3236105d5e6372b9cac9b36671001cd1c4f397d7272dc"",""script"":"""",""index"":0,""prev_out"":{""addr"":""bc1q3cgdefzx6c8s9z4hnnze3klvt3nkatyw6wpmsw"",""n"":1,""script"":""00148e10dca446d60f028ab79cc598dbec5c676eac8e"",""spending_outpoints"":[{""n"":0,""tx_index"":4435293985061397}],""spent"":true,""tx_index"":2299444886242235,""type"":0,""value"":146568773}}]","[{""type"":0,""spent"":true,""value"":146395587,""spending_outpoints"":[{""tx_index"":5768580839908541,""n"":0}],""n"":0,""tx_index"":4435293985061397,""script"":""00143ef5e3ad954ac25e3b95dbc185b1a0f65d346aa3"",""addr"":""bc1q8m678tv4ftp9uwu4m0qctvdq7ewng64ru8sp8e""},{""type"":0,""spent"":false,""value"":170000,""spending_outpoints"":[],""n"":1,""tx_index"":4435293985061397,""script"":""76a914a0b0d60e5991578ed37cbda2b17d8b2ce23ab29588ac"",""addr"":""1FeexV6bAHb8ybZjqQMjJrcCrHGW9sb6uF""}]",170000,7995722041370
"8aa30f790f433cb58e7a44c02507d048c582c9aa95836ff467005bcb851f7c91",2,1,2,225,900,226,"0.0.0.0",747737,5118793306696544,false,1659494039,747739,747739,"[{""sequence"":4294967293,""witness"":"""",""script"":""47304402202c52f8ed7a2d99347fa6000538166bd3533a6068c39ba16134338e4cce085a3102203174af9a958e069b101fa1356c8034e1b585cb1139cd2a3807b8d6e4bd35a93c01210271af47811d27a3974aeec545980871b34272ffe90799b9f63a636455689f6615"",""index"":0,""prev_out"":{""addr"":""1DV826nwZbRWdd7AR5n1tYg7mHVYDJdBF1"",""n"":1,""script"":""76a91488f303f5e537963437ea8b8d003aad02722ae34c88ac"",""spending_outpoints"":[{""n"":0,""tx_index"":5118793306696544}],""spent"":true,""tx_index"":109974740290864,""type"":0,""value"":23256}}]","[{""type"":0,""spent"":false,""value"":888,""spending_outpoints"":[],""n"":0,""tx_index"":5118793306696544,""script"":""76a914a0b0d60e5991578ed37cbda2b17d8b2ce23ab29588ac"",""addr"":""1FeexV6bAHb8ybZjqQMjJrcCrHGW9sb6uF""},{""type"":0,""spent"":true,""value"":22142,""spending_outpoints"":[{""tx_index"":177833593306725,""n"":0}],""n"":1,""tx_index"":5118793306696544,""script"":""76a914a281c9d32e2f8d76532edf6dc38eabadb9b1768c88ac"",""addr"":""1FpFww1SuGdEiyhjQoQxndqpsiC6hArGjY""}]",888,7995721871370
"66cb33f72c0ff98e85ac2e6e30695451e124ffc12d58321f988769a2ea2b2003",2,1,2,225,900,2283,"0.0.0.0",747733,109974740290864,false,1659492634,747734,747734,"[{""sequence"":4294967293,""witness"":"""",""script"":""4730440220580290a4c48bb10584f6534d4673f8300741b3bce70b9075f91d2a62b32e6dab022079e74366795097106b80af10ab60d99afaa33975a31254b25011441d2eea1c0701210379298995ba61c8abae3e22d7716520b47eedf47e537034d470b492c49bb1a1ae"",""index"":0,""prev_out"":{""addr"":""1Gj7oQSRRS6yT6y1WAVb7QNqtR6zux6dDs"",""n"":0,""script"":""76a914ac810897b8b19f021ca62d89110a2e2b6ba2dfa788ac"",""spending_outpoints"":[{""n"":0,""tx_index"":109974740290864}],""spent"":true,""tx_index"":3971252607234299,""type"":0,""value"":26507}}]","[{""type"":0,""spent"":false,""value"":968,""spending_outpoints"":[],""n"":0,""tx_index"":109974740290864,""script"":""76a914a0b0d60e5991578ed37cbda2b17d8b2ce23ab29588ac"",""addr"":""1FeexV6bAHb8ybZjqQMjJrcCrHGW9sb6uF""},{""type"":0,""spent"":true,""value"":23256,""spending_outpoints"":[{""tx_index"":5118793306696544,""n"":0}],""n"":1,""tx_index"":109974740290864,""script"":""76a91488f303f5e537963437ea8b8d003aad02722ae34c88ac"",""addr"":""1DV826nwZbRWdd7AR5n1tYg7mHVYDJdBF1""}]",968,7995721870482
"c7cd24d596228254ffdd7375f8f04789386c03d5bc714b3e1ca58df2ef608cb6",1,1,8,417,1338,5276,"0.0.0.0",0,6422849216467380,false,1659366618,747511,747511,"[{""sequence"":4294967295,""witness"":""02483045022100c3b9422fc5df7251e904e8e2acb233db081ad6b63b302af16e3cb0a73bfe2d1d02203c27af72877162ca785b14b8f593a46bd9aa349e8fc89ea2403b70ef0b9dd58a0121030f7c3def8105edb2e0f7dbed23e19ba49e4485b731a24bcc14aee8d51a75ee38"",""script"":"""",""index"":0,""prev_out"":{""addr"":""bc1qmgj3w0aw5455y9s4zfhts2kxm4qstwyjx5f907"",""n"":8,""script"":""0014da25173faea569421615126eb82ac6dd4105b892"",""spending_outpoints"":[{""n"":0,""tx_index"":6422849216467380}],""spent"":true,""tx_index"":8652485193811204,""type"":0,""value"":14258906829}}]","[{""type"":0,""spent"":true,""value"":426076,""spending_outpoints"":[{""tx_index"":5583726522594938,""n"":197}],""n"":0,""tx_index"":6422849216467380,""script"":""0014e64f9e7fa49b447ddbbee8f3a08fd46e7282c7be"",""addr"":""bc1que8eulayndz8mka7are6pr75deeg93a7aj2t6n""},{""type"":0,""spent"":true,""value"":553133,""spending_outpoints"":[{""tx_index"":1427434131012913,""n"":0}],""n"":1,""tx_index"":6422849216467380,""script"":""76a9146df755a93f39523290502e8543891cfc1b6eb61988ac"",""addr"":""1B2Sx29TMZJqTq4zFF6uKkFLzsrYQVnPH2""},{""type"":0,""spent"":false,""value"":426654,""spending_outpoints"":[],""n"":2,""tx_index"":6422849216467380,""script"":""001467a58fb543c9f7678b834ada70ec85417104d59c"",""addr"":""bc1qv7jcld2re8mk0zurftd8pmy9g9csf4vuq57efq""},{""type"":0,""spent"":true,""value"":213383,""spending_outpoints"":[{""tx_index"":6892078921544004,""n"":221}],""n"":3,""tx_index"":6422849216467380,""script"":""a914bf2ab9bc1adc00384b1dfaf04e11e051049a967d87"",""addr"":""3K7pAoeEe6XcnxwZ8gbD8wtqqK18qTQMGU""},{""type"":0,""spent"":false,""value"":5300,""spending_outpoints"":[],""n"":4,""tx_index"":6422849216467380,""script"":""76a914a0b0d60e5991578ed37cbda2b17d8b2ce23ab29588ac"",""addr"":""1FeexV6bAHb8ybZjqQMjJrcCrHGW9sb6uF""},{""type"":0,""spent"":false,""value"":5087445,""spending_outpoints"":[],""n"":5,""tx_index"":6422849216467380,""script"":""001459c6e2dd9e0e310e052a1de4dd2a9338ba34f1ec"",""addr"":""bc1qt8rw9hv7pccsupf2rhjd625n8zarfu0vmljkcf""},{""type"":0,""spent"":true,""value"":4258682,""spending_outpoints"":[{""tx_index"":8102933550695313,""n"":33}],""n"":6,""tx_index"":6422849216467380,""script"":""a914ea5e966def15c47c3dc0cc8e6d39d24147b972cf87"",""addr"":""3P4FMVegG5s4314yjXwGVPaqp9oU5VCJvN""},{""type"":0,""spent"":true,""value"":14247930880,""spending_outpoints"":[{""tx_index"":7528665711219057,""n"":0}],""n"":7,""tx_index"":6422849216467380,""script"":""0014da25173faea569421615126eb82ac6dd4105b892"",""addr"":""bc1qmgj3w0aw5455y9s4zfhts2kxm4qstwyjx5f907""}]",5300,7995721869514